# Glossary in tab-separated format -*- coding: utf-8 -*-
AFoolAndHisNewMoneyAreSoonParted	Br/UmToloESeuDinheiroLogoSeSeparam
AFriendInNeed	Br/AmigoEstouAqui
AGodIAm	Br/SouUmDeus
AGodIAmNot	Br/NaoSouUmDeus
AGodIsYou	Br/VoceEUmDeus
AMillionIsAStatistic	Br/UmMilhaoEUmaEstatistica
ANaziByAnyOtherName	Br/UmNazistaComQualquerOutroNome
AWinnerIsYou	Br/UmVencedorEVoce
AbandonedHospital	Br/HospitalAbandonado
AboveGoodAndEvil	Br/AcimaDoBemEDoMal
AbusiveParents	Br/PaisAbusivos
AchillesHeel	Br/CalcanharDeAquiles
ActuallyIAmHim	Br/NaVerdadeEuSouEle
ActuallyPrettyFunny	Br/NaVerdadeFoiBemEngracado
AdaptationDecay	Br/DecaimentoAdaptativo
AdaptationDisplacement	Br/DeslocamentoDaAdaptacao
AdaptationExpansion	Br/AdaptacaoExpansiva
AdaptationalVillainy	Br/VilaniaInduzidaPorAdaptacao
Administrivia/InUniverseExamplesOnly	BrAdministrivia/SomenteExemplosInUniverso
Administrivia/IsThisTropable	BrAdministrivia/IssoETropavel
Administrivia/LumperVsSplitter	BrAdministrivia/AgregadorContraSeparador
Administrivia/NoRealLifeExamplesPlease	BrAdministrivia/SemExemplosDaVidaRealPorFavor
Administrivia/NoTropeIsTooCommon	BrAdministrivia/NenhumTropoEComumDemais
Administrivia/NotATrope	BrAdministrivia/NaoEUmTropo
Administrivia/PeopleSitOnChairs	BrAdministrivia/PessoasSentamEmCadeiras
Administrivia/PermanentRedLinkClub	BrAdministrivia/ClubeDoLinkVermelhoPermanente
Administrivia/RidiculouslySimilarTrope	BrAdministrivia/TropoRidiculamenteSimilar
Administrivia/SquarePegRoundTrope	BrAdministrivia/PorcaQuadradaTropoRedondo
Administrivia/TVTropesForum	BrAdministrivia/ForumDoTVTropes
Administrivia/TheSameButMore	BrAdministrivia/OMesmoSoQueMais
Administrivia/TheSameButMoreSpecific	Administrivia/OMesmoSoQueMaisEspecifico
Administrivia/ThreeRulesOfThree	BrAdministrivia/TresRegrasDeTres
Administrivia/TooRareToTrope	BrAdministrivia/RaroDemaisParaSerUmTropo
Administrivia/TropesAreFlexible	BrAdministrivia/TroposSaoFlexiveis
Administrivia/TropesAreNotBad	BrAdministrivia/TroposNaoSaoRuins
Administrivia/TropesAreTools	BrAdministrivia/TroposSaoFerramentas
Administrivia/TvTropesGlossary	BrAdministrivia/GlossarioDoTVTropes
AdventuresInComaland	Br/AventurasDeAliceNoPaisDoComa
AesopAmnesia	Br/AmnesiaDeEsopo
AgainstMyReligion	Br/ContraAMinhaReligiao
AgentMulder	Br/AgenteMulder
AirVentPassageway	Br/PassagemPelosDutosDeAr
AlasPoorVillain	Br/InfelizmentePobreVilao
AlbumTitleDrop	Br/FalarONomeDoAlbum
AlienGeometries	Br/GeometriasAlien
AllAccordingToPlan	Br/TudoDeAcordoComOPlano
AllCrimesAreEqual	Br/TodosOsCrimesSaoIguais
AllGaysArePromiscuous	Br/TodosOsGaysSaoPromiscuos
AllIsWellThatEndsWell	Br/TudoEstaBemQuandoAcabaBem
AllJustADream	Br/EraTudoUmSonho
AllOfTheOtherReindeer	Br/TodasAsOutrasRenas
AllPsychologyIsFreudian	Br/TodaPsicologiaEFreudiana
AlternateCatchphraseInflection	Br/InflexaoAlternativaDeBordao
AlternateCharacterInterpretation	Br/InterpretacaoAlternativaDePersonagem
AlternateUniverseReedRichardsIsAwesome	Br/ReedRichardsDoUniversoAlternativoEIncrivel
AluminumChristmasTrees	Br/ArvoresDeNatalDeAluminio
AluminumChristmasTrees	Br/ArvoresNatalinasDeAluminio
AlwaysChaoticEvil	Br/SempreCaoticoEMau
AlwaysLawfulGood	Br/SempreLealEBom
AmbitionIsEvil	Br/AmbicaoEDoMal
AmbitionIsEvil	Br/AmbicaoEMaligna
Americanization	Br/{{Americanizacao}}
AmmunitionConservation	Br/ConservacaoDeMunicao
AmoralAttorney	Br/AdvogadoAmoral
AnAesop	Br/UmEsopo
AnIndexOfLadiesAndGentlemen	Br/UmIndiceDeDamasECavalheiros
AnachronismStew	Br/SopaDeAnacronismo
AncientAstronauts	Br/AntigosAstronautas
AncientConspiracy	Br/AntigaConspiracao
AncientConspiracy	Br/ConspiracaoAntiga
AndKnowingIsHalfTheBattle	Br/ESaberEMetadeDaBatalha
AndThatsTerrible	Br/EIssoETerrivel
AndTheAdventureContinues	Br/EAAventuraContinua
AndYouWereThere	Br/EVoceEstavaLa
Angst	Br/{{Angustia}}
AnimalWrongsGroup	Br/GrupoPelosEsquerdosDosAnimais
AnimateInanimateObject	Br/ObjetoInanimadoAnimado
AnimationAgeGhetto	Br/GuetoDaIdadeParaAnimacao
AnnoyingYoungerSibling	Br/IrmaoMaisNovoIrritante
AnthropicPrinciple	Br/PrincipioAntropico
AntiHero	Br/AntiHeroi
AntiIntellectualism	Br/AntiIntelectualismo
AntiRoleModel	Br/PersonagemAntiModelo
AntiSchoolUniformsPlot	Br/TramaAntiUniformeEscolar
AntiVillain	Br/AntiVilao
Anvilicious	Br/{{Bigornada}}
AnyoneCanDie	Br/QualquerUmPodeMorrer
ApocalypseCult	Br/CultoDoApocalipse
ApocalypticLog	Br/DiarioDoApocalipse
ApparentlyPowerlessPuppetmaster	Br/FantochistaSemControleAparente
ArcFatigue	Br/FadigaDeArco
ArcWords	Br/PalavrasDeArco
ArchetypalCharacter	Br/PersonagemArquetipico
ArchiveBinge	Br/MaratonaDeArquivo
ArkhamsRazor	Br/NavalhaDeArkham
ArmedWithCanon	Br/ArmadoComOCanone
ArsonMurderAndJaywalking	Br/RouboAssassinatoEAtravessarForaDaFaixa
ArsonMurderAndJaywalking	Br/RouboHomicidioEAtravessarForaDaFaixa
ArsonMurderAndLifesaving	Br/RouboHomicidioESalvamentoDeVida
ArtShift	Br/MudancaArtistica
ArtifactTitle	Br/NomeArtefato
ArtisticLicenseBiology	Br/LicencaArtisticaBiologia
AsHimself	Br/ComoSiMesmo
AsLethalAsItNeedsToBe	Br/TaoLetalQuantoNecessario
AsLongAsItSoundsForeign	Br/DesdeQueSoeEstrangeiro
AscendedFanFic	Br/FanficAscendida
AscendedToAHigherPlaneOfExistence	Br/AscenderParaUmPlanoSuperiorDaExistencia
AssPull	Br/SolucaoTiradaDaBunda
AstralProjection	Br/ProjecaoAstral
AudienceAlienatingEra	Br/EraDeAlienacaoDoPublico
AudienceSurrogate	Br/SuplenteDaPlateia
AuthorAppeal	Br/ApeloDoAutor
AuthorFilibuster	Br/ObstrucaoDeAutor
AuthorTract	Br/TratadoDoAutor
AuthorsSavingThrow	Br/JogadaDefensivaDoAutor
AwesomeButImpractical	Br/FantasticoPoremImpratico
BFG	Br/ArmaGPC
BabiesEverAfter	Br/BebesParaSempre
BackFromTheDead	Br/DeVoltaDosMortos
BackportedDevelopment	Br/DesenvolvimentoRetroativo
Backstory	Br/HistoriaDeFundo
BackupBluff	Br/BlefeDosReforcos
BadassDecay	Br/DecaimentoFodanico
BadassPacifist	Br/FodaoPacifista
BaitAndSwitch	Br/PescaETroca
BaitTheDog	Br/AtrairOCachorro
BalanceBetweenGoodAndEvil	Br/EquilibrioEntreOBemEOMal
BallsGag	Br/PiadaComBolas
BannedInChina	Br/BanidoNaChina
BasedOnAGreatBigLie	Br/BaseadoEmUmaGrandeEEnormeMentira
BatDeduction	Br/BatDeducao
BatmanGambit	Br/GambitoDeBatman
BattleOfWits	Br/BatalhaDeIntelecto
BavarianFireDrill	Br/SimulacaoDeIncendioBavara
BeautyIsBad	Br/BelezaEMa
BecomingTheMask	Br/TornarSeAMascara
BedTrick	Br/TruqueDaCama
BefriendingTheEnemy	Br/AmigarSeComOInimigo
BeginnersLuck	Br/SorteDePrincipiante
BeingTorturedMakesYouEvil	Br/SerTorturadoTeFazDoMal
BellisariosMaxim	Br/MaximaDeBellisario
BetaCouple	Br/CasalBeta
BetterOnDVD	Br/MelhorNoDVD
BeyondRedemption	Br/AlemDaRedencao
BeyondTheImpossible	Br/AlemDoImpossivel
BigBad	Br/GrandeMal
BigBad	Br/Malvadao
BigBad	Br/Malzao
BigEater	Br/{{Comilao}}
Bittersweet17	Br/Inquietos17	Inquietos dezessete anos.
BittersweetEnding	Br/FinalAgridoce
BlackAndWhiteInsanity	Br/InsanidadeBinaria
BlackAndWhiteInsanity	Br/InsanidadePretaEBranca
BlackAndWhiteMorality	Br/MoralidadeBinaria
BlackAndWhiteMorality	Br/MoralidadePretaEBranca
BlackComedy	Br/HumorNegro
BlackDotPupils	Br/PupilasDeBolinhasPretas
BlamedForBeingRailroaded	Br/LevouACulpaPorTerSidoEmpurrado
BlatantLies	Br/MentirasDescaradas
BlobMonster	Br/MonstroDeGosma
BloodKnight	Br/CavaleiroDeSangue
BlownAcrossTheRoom	Br/LancadoAtravesDaSala
BodyBackupDrive	Br/CorpoReserva
BodyHorror	Br/HorrorCorporal
BodySurf	Br/SurfeCorporal
BoltOfDivineRetribution	Br/RaioDaDivinaRetribuicao
BoringButPractical	Br/ChatoPoremPratico
BoringReturnJourney	Br/JornadaEntedianteDeRetorno
BornAgainImmortality	Br/ImortalidadePorRenascimento
BornLucky	Br/SortudoDeNascenca
BottleEpisode	Br/EpisodioEngarrafado
BottomlessPits	Br/FossoSemFundo
BoxOfficeBomb	Br/BombaDeBilheteria
Br/UnrevealAngle	Br/AnguloDeNaoRevelacao
BreakHisHeartToSaveHim	Br/PartaOCoracaoDeleParaOSalvar
BreakThemByTalking	Br/AcabarComElesFalando
BrickJoke	Br/PiadaDeTijolo
BrilliantButLazy	Br/BrilhantePoremPreguicoso
BringMyBrownPants	Br/TragaMinhasCalcasMarrons
BringMyRedJacket	Br/TragaMeuCasacoVermelho
BroadStrokes	Br/PinceladasLargas
BrokenMasquerade	Br/QuedaDeMascaras
BrokenSystemDogmatist	Br/DogmatistaDoSistemaFalho
BrutalBonusLevel	Br/FaseBonusBrutal
BrutalHonesty	Br/HonestidadeBrutal
BuffySpeak	Br/DialetoCoisado
BunnyEarsLawyer	Br/AdvogadoComOrelhasDeCoelho
BurnTheWitch	Br/QueimemABruxa
BurningWithAnger	Br/QueimandoDeRaiva
ButNotTooEvil	Br/MasNaoMuitoMau
ButNotTooForeign	Br/MasNaoMuitoEstrangeiro
ButNotTooGay	Br/MasNaoMuitoGay
ButThouMust	Br/MasTuDeves
ButWaitTheresMore	Br/MasEspereTemMais
ButtMonkey	Br/{{Corinho}}
BystanderSyndrome	Br/SindromeDoObservador
CListFodder	Br/BuchaDeClasseC
CallBack	Br/PegouAReferencia
CallForward	Br/ReferenciaFutura
CallingTheOldManOut	Br/DarUmSermaoNoVelho
CallingTheYoungManOut	Br/DarUmSermaoNoJovem
CallingYourAttacks	Br/NomearSeusAtaques
CameBackWithAVengeance	Br/VoltouTrazendoVinganca
CampGay	Br/GayCamp
CanonDiscontinuity	Br/DescontinuidadeDeCanone
CanonMarchesOn	Br/AMarchaDoCanone
CantGetAwayWithNothing	Br/NaoDaPraSeSafarDeNada
CantTakeCriticism	Br/NaoAceitaCriticas
CaptainObvious	Br/CapitaoObvio
CaptainObviousReveal	Br/RevelacaoDeCapitaoObvio
CaptainObviousReveal	Br/RevelacaoDeCapitaoObvio
CardCarryingVillain	Br/VilaoDeCrachaETudo
CardboardPrison	Br/PrisaoDePapelao
CartwrightCurse	Br/MaldicaoDoCartwright
CashCowFranchise	Br/FranquiaDosOvosDeOuro
CassandraGambit	Br/GambitoDeCassandra
CassandraTruth	Br/VerdadeDeCassandra
CastFullOfCrazy	Br/ElencoRepletoDeMalucos
CastTheExpert	Br/EspecialistaNoElenco
CasualKink	Br/FeticheCasual
Catchphrase	Br/Bordao
CatsAreSnarkers	Br/GatosSaoSarcasticos
CerebusRetcon	Br/RetconDeCerebus
CerebusSyndrome	Br/SindromeDeCerebus
ChannelHop	Br/MudancaDeCanal
ChaoticEvil	Br/CaoticoEMau
ChaoticGood	Br/CaoticoEBom
ChaoticNeutral	Br/CaoticoENeutro
ChaoticStupid	Br/CaoticoEEstupido
CharacterDerailment	Br/DescarrilamentoDePersonagem
CharacterDerailment	Br/DescarrilhamentoDePersonagem
CharacterDevelopment	Br/DesenvolvimentoDePersonagem
CharacterExaggeration	Br/ExageroDePersonagem
CharacterTitle	Br/PersonagemTitulo
CharacterizationMarchesOn	Br/AMarchaDaCaracterizacao
CharacterizationMarchesOn	Br/MarchaDaCaracterizacao
CharactersDroppingLikeFlies	Br/PersonagensCaindoComoMoscas
ChekhovsGag	Br/PiadaDeChekhov
ChewToy	Br/BrinquedoDeMorder
ChewingTheScenery	Br/MastigandoOCenario
ChristmasRushed	Br/AceleradoParaONatal
ChuckCunninghamSyndrome	Br/SindromeDeChuckCunningham
ChurchMilitant	Br/MilitanteDaIgreja
ClearMyName	Br/LimparMeuNome
ClearMyName	Br/LimparONome
ClipShow	Br/SerieDeClipes
ClockKing	Br/ReiRelogio
CloningGambit	Br/GambitoDoClone
CloseEnoughTimeline	Br/LinhaTemporalBoaOBastante
CloserThanTheyAppear	Br/MaisPertoDoQueParece
Cloudcuckoolander	Br/DiLuaLovegood
Cloudcuckoolander	Br/OAvoado
Cloudcuckoolander	Br/OLunatico
ClueEvidenceAndASmokingGun	Br/PistasEvidenciasEUmaArmaFumegante
ClusterFBomb	Br/GranadaProfanica
CockFight	Br/RinhaDeGalo
CombatPragmatist	Br/LutadorPragmatico
ComedicSociopathy	Br/SociopatiaComica
ComicBook	BrQuadrinhos
ComicBook/JusticeLeagueOfAmerica	BrQuadrinhos/LigaDaJusticaDaAmerica
ComicBookTime	Br/FusoQuadrinhos
ComicBookTropes	Br/TroposDeHistoriasEmQuadrinhos
ComicStrip/CalvinAndHobbes	BrQuadrinhos/CalvinEHaroldo
ComicTrio	Br/TrioComico
ComicallyMissingthePoint	Br/ComicamentePerdendoOPonto
CommitmentAnxiety	Br/ReceioDeCompromisso
CompanyCrossReferences	Br/ReferenciaCruzadaCorporativa
CompensatingForSomething	Br/CompensandoPorAlgo
CompetenceZone	Br/ZonaDeCompetencia
CompleteImmortality	Br/ImortalidadeCompleta
CompleteMonster	Br/MonstroCompleto
ConMan	Br/OTrambiqueiro
ConMan	Br/OVigarista
CondemnedByHistory	Br/CondenadoPelaHistoria
ConsummateLiar	Br/MentirosoContumaz
ContinuingIsPainful	Br/ContinuarEDolorido
ContinuityCavalcade	Br/CavalgadaDeReferencias
ContinuityDrift	Br/DesvioDeContinuidade
ContinuityLockout	Br/BloqueioDeContinuidade
ContinuityNod	Br/AcenoParaAContinuidade
ContinuitySnarl	Br/RosnadoDeContinuidade
ContractualImmortality	Br/ImortalidadeContratual
ContrivedCoincidence	Br/CoincidenciaConveniente
ContrivedStupidityTropes	Br/TroposDeEstupidezConveniente
ConvenientMiscarriage	Br/AbortoEspontaneoConveniente
ConvenientlyInterruptedDocument	Br/DocumentoConvenientementeInterrompido
ConversationalTroping	Br/TropagemConversacional
CorruptChurch	Br/IgrejaCorrupta
CosmicChessGame	Br/XadrezCosmico
CosmicPlaything	Br/BrinquedoCosmico
CosmicRetcon	Br/RetconCosmico
CoupleBomb	Br/CasalBomba
CousinOliver	Br/PrimoOliver
CowardiceCallout	Br/ApontarACovardice
CowboyBebopAtHisComputer	Br/CowboyBebopEmSeuComputador
CrapsackWorld	Br/MundoLixoso
CrapsackWorld	Br/MundoSacoDeLixo
CreativeDifferences	Br/DiferencasCriativas
Creator	BrCriador
Creator/MichaelMoorcock	BrCriador/MichaelMoorcock
Creator/PoulAnderson	BrCriador/PoulAnderson
Creator/RogerEbert	BrCriador/RogerEbert
CreatorBreakdown	Br/ColapsoDoCriador
CreatorsApathy	Br/ApatiaDoCriador
CreatorsPet	Br/QueridinhoDoCriador
CrimeAndPunishmentSeries	Br/SeriesDeCrimeECastigo
CriminalMindGames	Br/JogosMentaisCriminosos
CringeComedy	Br/ComediaCringe
CringeComedy	Br/ComediaEmbaracosa
CrisisCrossover	Br/CruzamentoDeCrise
Crossover	Br/Cruzamento
CrutchCharacter	Br/PersonagemMuleta
CryForTheDevil	Br/ChorarPeloDiabo
Cuckold	Br/{{Corno}}
CueTheFallingObject	Br/MomentoDoObjetoEmQueda
CulturalCrossReference	Br/ReferenciaCulturalCruzada
CutenessProximity	Br/ProximidadeDaFofura
DadaAd	Br/DadaAnuncio
DamselInDistress	Br/DonzelaEmPerigo
DarkAndTroubledPast	Br/PassadoSombrioEComplicado
DarkIsNotEvil	Br/AsTrevasNaoSaoMas
DarkerAndEdgier	Br/MaisSombrioEPesado
DarthWiki	BrWikiSombria	"Darth Wiki" é um namespace.
DarthWiki/RuinedForever	BrWikiSombria/ArruinadoParaSempre
DarthWiki/TVTropesRuinedYourLife	BrWikiSombria/TVTropesArruinouSuaVida
DastardlyWhiplash	Br/VigaristaCaricato
DatedHistory	Br/HistoriaDatada
DeadGuyJunior	Br/DefuntoDaSilvaFilho
DeadGuyJunior	Br/DefuntoDaSilvaJunior
Deadpan Snarker	Sarcástico Sério
DeadpanSnarker	Br/SarcasticoSerio
DealWithTheDevil	Br/PactoComODemonio
DealWithTheDevil	Br/PactoComODiabo
DeathByOriginStory	Br/MortePorHistoriaDeOrigem
DeathEqualsRedemption	Br/MorteSignificaRedencao
DeathGlare	Br/OlharDaMorte
DeathIsCheap	Br/MorrerEBarato
DeathIsCheap	Br/MorteEBarata
DeathOfAThousandCuts	Br/MortePorMilCortes
DeathSeeker	Br/BuscadorDaMorte
DeconstructedTrope	Br/TropoDesconstruido
DelayedOhCrap	Br/VishFerrouAtrasado
DeletionAsPunishment	Br/ApagamentoComoPunicao
DeliberateValuesDissonance	Br/DissonanciaDeValoresDeliberada
DemiurgeArchetype	Br/ArquetipoDemiurgico
DemonicPossession	Br/PossessaoDemoniaca
Demonization	Br/{{Demonizacao}}
DenialOfDiagonalAttack	Br/NegacaoDeAtaqueDiagonal
Denouement	Br/{{Desfecho}}
DenserAndWackier	Br/MaisDensoEEstranho
DepartmentOfRedundancyDepartment	Br/DepartamentoDeRedundanciaRedundante
DependingOnTheArtist	Br/DependeDoArtista
DependingOnTheWriter	Br/DependeDoRoteirista
DependingOnTheWriter	Br/DependendoDoEscritor
DerangedAnimation	Br/AnimacaoPerturbada
DescriptionCut	Br/CorteDescritivo
DesignatedHero	Br/HeroiDesignado
DeusExMachina	Br/DeusExMachina
DevelopmentHell	Br/InfernoDoDesenvolvimento
DevilComplex	Br/ComplexoDeDiabo
DevilInPlainSight	Br/DiaboEmPlenaVista
DiagnosisOfGod	Br/DiagnosticoDeDeus
DidNotGetTheGirl	Br/NaoConseguiuAGarota
DidTheyOrDidntThey	Br/ElesFizeramOuNao
DidYouDie	Br/VoceMorreu
DidntWeUseThisJokeAlready	Br/JaNaoUsamosEssaPiadaAntes
DiedDuringProduction	Br/MorreuDuranteAProducao
DifficultButAwesome	Br/DificilPoremFantastico
DifficultyLevels	Br/NiveisDeDificuldade
DifficultySpike	Br/SaltoNaDificuldade
DirtyBusiness	Br/TrabalhoSujo
DisabledSnarker	Br/SarcasticoPCD
DiscontinuityNod	Br/AcenoParaADescontinuidade
DiscreditedTrope	Br/TropoDesacreditado
DisintegratorRay	Br/FeixeDesintegrador
DisintegratorRay	Br/RaioDesintegrador
DisneyDeath	Br/MorteDisney
DisneyDeath	Br/MorteEstiloDisney
Disneyfication	Br/{{Disneyficacao}}
DisposableSexWorker	Br/ProfissionalSexualDescartavel
DisproportionateRetribution	Br/RetribuicaoDesproporcional
DisqualificationInducedVictory	Br/VitoriaInduzidaPorDesqualificacao
DistressBall	Br/BolaDoPerigo
DistressedDude	Br/PrincesoEmPerigo	Literalmente seria "cara em perigo", mas o uso de "princeso" e "donzelo" ganhou alguma tração.
DivideAndConquer	Br/DividirParaConquistar
DivorceIsTemporary	Br/DivorcioETemporario
DodgeTheBullet	Br/DesviarDaBala
DoesNotLikeSpam	Br/NaoGostaDeFigado	O "Spam" não é realmente famoso no Brasil, mas o fígado é uma comida amplamente rejeitada. Assim como passas.
DomesticAbuse	Br/AbusoDomestico
DontExplainTheJoke	Br/NaoExpliqueAPiada
DontTryThisAtHome	Br/NaoTenteIssoEmCasa
DontYouDarePityMe	Br/NaoOuseTerPenaDeMim
DoomedByCanon	Br/CondenadoPeloCanone
DoubleEntendre	Br/PiadaDeDuploSentido
DoubleMeaning	Br/DuploSentido
DownTheRabbitHole	Br/DescendoATocaDoCoelho
DownerEnding	Br/FinalDepressivo
DracoInLeatherPants	Br/DracoEmCalcasDeCouro
DramaticIrony	Br/IroniaDramatica
DreamWithinADream	Br/SonhoDentroDoSonho
DreamingOfThingsToCome	Br/SonhandoComAquiloQueVira
DroppedABridgeOnHim	Br/CaiuUmaPonteNele
DrunkOnMilk	Br/BebadoDeLeite
DrunkOnTheDarkSide	Br/InebriadoPeloLadoNegro
DualWielding	Br/EmpunhaduraDupla
DubInducedPlotlineChange	Br/MudancaDeTramaInduzidaPorDublagem
DudeNotFunny	Br/CaraNaoFoiLegal
DudeWheresMyRespect	Br/CaraCadeMeuRespeito
DudeWheresMyReward	Br/CaraCadeMinhaRecompensa
DumbassHasAPoint	Br/OIdiotaTemRazao
DumpMonths	Br/MesesDeEntulho
DungeonMastersGirlfriend	Br/NamoradaDoMestreDaMasmorra
DyingMomentOfAwesome	Br/MomentoIncrivelDeMorte
DysfunctionJunction	Br/JuncaoDisfuncional
EarnYourFun	Br/ConquisteSuaDiversao
EarnYourHappyEnding	Br/ConquistarOFinalFeliz
EasilyDetachableRobotParts	Br/PartesRoboticasQueDesencaixamFacil
EasingIntoTheAdventure	Br/AAventuraVemDeMansinho
EasyModeMockery	Br/ZombariaDoModoFacil
EasyRoadToHell	Br/ViaExpressaParaOInferno
EditWar	Br/GuerraDeEdicoes
EldritchAbomination	Br/AbominacaoSobrenatural
EldritchLocation	Br/LugarAlienigena
ElmuhFuddSyndwome	Br/SindlomeDeCebolinha
EmotionalTorque	Br/TorqueEmocional
EmptyShell	Br/CascoVazio
EndOfAnAge	Br/OFimDeUmaEra
EndOfAnEra	Br/OFimDeUmaEra
EndOfTheWorldSpecial	Br/EspecialDeFimDoMundo
EnemyMine	Br/InimigoDoMeuInimigo
EntendreFailure	Br/DuploSentidoFalho
EpilepticTree	Br/ArvoresEpileticas
EsotericHappyEnding	Br/FinalFelizEsoterico
EtTuBrute	Br/AteTuBrutus
EternalProhibition	Br/ProibicaoEterna
EuphemismBuster	Br/DestruidorDeEufemismo
EuphemisticName	Br/NomeEufemista
EvenEvilHasStandards	Br/AteOMalTemLimites
EveryEpisodeEnding	Br/TodoFinalDeEpisodio
EveryProperLadyShouldCurtsy	Br/TodaDamaDeRespeitoDeveCortejar
EverybodyDiesEnding	Br/TodoMundoMorre
EverybodyLaughsEnding	Br/FinalTodoMundoRindo
EverybodysDeadDave	Br/EstaoTodosMortosDave
EverythingTryingToKillYou	Br/TudoTentandoTeMatar
EvilCannotComprehendGood	Br/OMalNaoPodeEntenderOBem
EvilCounterpart	Br/ContraparteDoMal
EvilInc	Br/DoMalLtda
EvilIsCool	Br/OMalELegal
EvilMatriarch	Br/MatriarcaDoMal
EvilMinions	Br/LacaiosDoMal
EvilOverlord	Br/SoberanoDoMal
EvilPlan	Br/PlanoDoMal
EvilVersusEvil	Br/MalContraMal
EvilerThanThou	Br/MaisMalvadoQueTu
EvilerThanThou	Br/SouMaisMalvadoQueVoce
ExactlyWhatItSaysOnTheTin	Br/ExatamenteOQueEstaEscrito
ExaggeratedTrope	Br/TropoExagerado
ExaggeratedTrope	Br/TropoExagerado
ExcusePlot	Br/OEnredoESoUmaDesculpa
ExecutiveMeddling	Br/InterferenciaExecutiva
ExecutiveVeto	Br/VetoExecutivo
ExpandedUniverse	Br/UniversoExpandido
ExpendableClone	Br/CloneDescartavel
ExplainExplainOhCrap	Br/ExpliqueExpliqueVishFerrou
ExponentialPlotDelay	Br/AtrasoExponencialDeTrama
Exposition	Br/{{Exposicao}}
ExternalRetcon	Br/RetconExterno
ExtraStrengthMasquerade	Br/MascaramentoExtraForte
ExtremeDoormat	Br/CapachoExtremo
ExtremeOmnisexual	Br/OmnisexualExtremo
ExtremeOmnivore	Br/OnivoroExtremo
FaceHeelTurn	Br/PassandoProLadoDosViloes
FaceHeelTurn	Br/PassarParaOLadoDosViloes
FaceRealisation	Br/PercepcaoDeBondade
FaceRealization	Br/PercepcaoDeBondade
FailedFutureForecast	Br/PrevisaoErradaDoFuturo
FailureHero	Br/HeroiFalho
FailureIsTheOnlyOption	Br/FalharEAUnicaOpcao
FairForItsDay	Br/JustoParaSeuTempo
FakeDifficulty	Br/DificuldadeArtificial
FakeWeakness	Br/FraquezaFalsa
FakeWeakness	Br/PseudoFraqueza
FakingTheDead	Br/FingindoDeMorto
FallenHero	Br/HeroiCaido
FalseDichotomy	Br/FalsaDicotomia
FalselyAdvertisedAccuracy	Br/ExatidaoFalsamenteAnunciada
FamilyValuesVillain	Br/AMaldadeASeguirELivreParaTodosOsPublicos
FanNickname	Br/ApelidoDosFas
FanonDiscontinuity	Br/DescontinuidadeDeFanone
FantasticallyIndifferent	Br/FantasticamenteIndiferente
FantasyGunControl	Br/EstatutoDoDesarmamentoFiccional
FashionDissonance	Br/DissonanciaFashion
FauxDeath	Br/MorteFalsa
FelonyMisdemeanor	Br/CrimeDeMauComportamento
FemmeFatale	Br/FemmeFatale
FencePainting	Br/PintarACerca
FightingAShadow	Br/LutandoContraUmaSombra
Filler	Br/{{Enchimento}}	Ou "filler" mesmo.
Film/AmericanBeauty	BrFilme/BelezaAmericana
Film/IndianaJonesAndTheKingdomOfTheCrystalSkull	BrFilme/IndianaJonesEOReinoDaCaveiraDeCristal
Film/ShootEmUp	BrFilme/MandandoBala
Film/TheDarkKnight	BrFilme/OCavaleiroDasTrevas
Film/TheThreeStooges	BrFilme/OsTresPatetas
FilmTheHand	Br/FilmarAMao
FinalBattle	Br/BatalhaFinal
FinaleTitleDrop	Br/FalarONomeNoFinal
FirstPersonSmartass	Br/EngracadinhoEmPrimeiraPessoa
FissionMailed	Br/FissaoMalha
FiveManBand	Br/GrupoDeCincoCaras
FiveManBandConcert	Br/ConcertoDeCincoCaras
FiveStagesOfGrief	Br/CincoEstagiosDoLuto
Flanderized	Br/{{Flanderizacao}}
FlatCharacter	Br/PersonagemPlano
FlawExploitation	Br/ExploracaoDeFalhas
FleetingDemographicRule	Br/RegraDaDemografiaPassageira
FlipFlopOfGod	Br/IndecisaoDeDeus
FloatingAdviceReminder	Br/LembreteFlutuante
FloatingTimeline	Br/FusoQuadrinhos	O termo de origem é uma redireção para "Comic-Book Time".
FlockOfWolves	Br/RebanhoDeLobos
FluffyCloudHeaven	Br/CeuDeNuvensFofas
Foil	Br/{{Fundo}}
FontAnachronism	Br/AnacronismoDeFonte
ForTheEvulz	Br/PorqueEuSouDuMalz
ForcedCreativity	Br/CriatividadeForcada
ForegoneConclusion	Br/ConclusaoConhecida
Foreshadowing	Br/{{Prenuncio}}
ForgotAboutHisPowers	Br/SeEsqueceuDosSeusPoderes
ForgotFlandersCouldDoThat	Br/EsqueciQueOFlandersPodiaFazerIsso
ForgotTheDisability	Br/SeEsqueceuDaDeficiencia
ForgottenFallenFriend	Br/AmigoFalecidoEsquecido
FormulaicMagic	Br/MagiaFormulaica
FourIsDeath	Br/QuatroSignificaMorte
FourManBand	Br/GrupoDeQuatroCaras
FourPointScale	Br/EscalaDeQuatroPontos
FramingDevice	Br/DispositivoDeEnquadramento
Franchise	BrFranquia
Franchise/StarTrek	BrFranquia/StarTrek
Franchise/TheHitchhikersGuideToTheGalaxy	BrFranquia/OGuiaDoMochileiroDasGalaxias
FranchiseKiller	Br/MatadorDeFranquia
FranchiseOriginalSin	Br/PecadoOriginalDaFranquia
FrankensteinsMonster	Br/MonstroDeFrankenstein
FreudWasRight	Br/FreudEstavaCerto
FreudianExcuseDenial	Br/NegacaoDaDesculpaFreudiana
FreudianExcuseIsNoExcuse	Br/DesculpaFreudianaNaoEDesculpa
FridayNightDeathSlot	Br/HoraDaMorteNaNoiteDeSexta
FridgeHorror	Br/HorrorDeGeladeira
FridgeLogic	Br/LogicaDeGeladeira
FriendlyEnemy	Br/RivalAmigavel
FriendlyScheming	Br/EsquemaAmigavel
FromASingleCell	Br/DeUmaUnicaCelula
FromBadToWorse	Br/DeMalAPior
FutureSocietyPresentValues	Br/SociedadeDoFuturoValoresDoPresente
GRatedSex	Br/SexoComCensuraLivre
GadgeteerGenius	Br/GenioDosApetrechos
GainaxEnding	Br/FinalGainax
GambitPileup	Br/AmontoamentoDeGambitos
GambitRoulette	Br/RoletaDeGambitos
GameMaster	Br/MestreDoJogo
GarnishingTheStory	Br/EmbelezarAHistoria
GenghisGambit	Br/GambitoDeGenghis
GeniusBonus	Br/BonusAosGenios
GenreKiller	Br/MatadorDeGenero
GenreSavvy	Br/LigadoNoGenero
GenreShift	Br/MudancaDeGenero
GentlemanSnarker	Br/SarcasticoCavalheiro
GeographicFlexibility	Br/FlexibilidadeGeografica
GetBackInTheCloset	Br/VolteParaOArmario
GetTheeToANunnery	Br/DirigeTeAUmConvento
GettingCrapPastTheRadar	Br/PassarMuambaPelaAlfandega
GhostReunionEnding	Br/FinalReuniaoFantasma
GirlOnGirlIsHot	Br/GarotaComGarotaESexy
GivingUpOnLogic	Br/DesistindoDaLogica
GivingUpOnLogic	Br/DesistirDaLogica
GoAndSinNoMore	Br/VaENaoPequesMais
GoalOrientedEvolution	Br/EvolucaoOrientadaAObjetivos
GodDoesNotOwnThisWorld	Br/EsteMundoNaoPertenceADeus
GodGuise	Br/DisfarceDeDeus
GodNeverSaidThat	Br/DeusNuncaDisseIsso
GoddamnedBats	Br/MalditosMorcegos
GodhoodSeeker	Br/BuscadorDaDivindade
GoneHorriblyRight	Br/DeuTerrivelmenteCerto
GonnaNeedMoreX	Br/PrecisamosDeMaisX
GoodAndEvilForYourConvenience	Br/BomEMauParaASuaConveniencia
GoodCounterpart	Br/ContraparteDoBem
GoodIsDumb	Br/OBemEBurro
GoodIsNotNice	Br/BomNaoEGentil
GoodIsNotNice	Br/SerBomNaoESerBonzinho
GoodNewsBadNews	Br/BoasEMasNoticias
GoodShepherd	Br/BomPastor
GothsHaveItHard	Br/ParaGoticosTudoEDificil
GradeSystemSnark	Br/SarcasticoComSistemaDeNotas
Greed	Br/{{Ganancia}}
GrinOfAudacity	Br/SorrisoAudaz
GroinAttack	Br/AtaqueNaVirilha
GrowingTheBeard	Br/CrescerABarba
GrowsOnTrees	Br/DaEmArvore
GuideDangIt	Br/MalditoGuia
GuileHero	Br/HeroiAstuto
GunsAkimbo	Br/ArmasAkimbo
GutPunch	Br/SocoNoEstomago
HairFlip	Br/ViradaDeCabelo
HairTriggerTemper	Br/PavioCurto
HandWave	Br/SoUmaPincelada
Handwave	Br/{{Pincelada}}
HanlonsRazor	Br/NavalhaDeHanlon
HannibalLecture	Br/SermaoDeHannibal
HappilyEverAfter	Br/FelizesParaSempre
HappyEndingOverride	Br/PassarPorCimaDoFinalFeliz
HarderThanHard	Br/MaisDificilQueODificil
HarmfulToTouch	Br/PerigosoTocar
HarmlessVillain	Br/VilaoInofensivo
HarsherInHindsight	Br/PesadoEmRetrospecto
HateSink	Br/RaloDeOdio
HaveYouTriedNotBeingAMonster	Br/JaTentouNaoSerUmMonstro
HeWhoFightsMonsters	Br/AqueleQueLutaComMonstros
HealingFactor	Br/FatorDeCura
HeartwarmingInHindsight	Br/FofoEmRetrospecto
Heaven	Br/{{Ceu}}
HeelFaceRevolvingDoor	Br/PortaGiratoriaDeViraCasaca
HeelFaceTurn	Br/PassandoProLadoDosMocinhos
HeelFaceTurn	Br/PassarParaOLadoDosMocinhos
HeelRealisation	Br/PercepcaoDeMaldade
HeelRealization	Br/PercepcaoDeMaldade
HehHehYouSaidX	Br/HeHeVoceDisseX
HeinousnessRetcon	Br/RetconCriminal
Hell	Br/{{Inferno}}
Herald	Br/OArauto
HereWeGoAgain	Br/LaVamosNosDeNovo
HeroAntagonist	Br/HeroiAntagonista
HeroInsurance	Br/SeguroHeroico
HeroWithBadPublicity	Br/HeroiComMaPublicidade
HeroicBSOD	Br/ColapsoHeroico
HeroicBSOD	Br/TelaAzulHeroica
HeroicRROD	Br/ColapsoFisicoHeroico
HeroicSacrifice	Br/SacrificioHeroico
HeroicWillpower	Br/ForcaDeVontadeHeroica
HesDeadJim	Br/EleEstaMortoJim
HighFantasy	Br/AltaFantasia
HighOnCatnip	Br/ChapadoComErvaDeGato
HilariousInHindsight	Br/HilarioEmRetrospecto
HilariouslyAbusiveChildhood	Br/InfanciaHilariamenteAbusiva
HilarityEnsues	Br/HilariedadesSeguemSe
HiredGuns	Br/{{Mercenarios}}
HisNameIs	Br/ONomeDeleE
HistoricalFiction	Br/FiccaoHistorica
HistoricalInJoke	Br/PiadaInternaHistorica
HiveMind	Br/MenteUnificada
HoYay	Br/EntaoEleE
HolierThanThou	Br/MaisSacroQueTu
HolierThanThou	Br/SouMaisSantoQueVoce
HollywoodHacking	Br/HackersHollywoodianos
HollywoodProvincialism	Br/ProvincialismoHollywoodiano
HollywoodStyle	Br/EstiloHollywood
Homage	Br/{{Homenagem}}
Homer	Homero	O filósofo grego, não o personagem dos Simpsons.
HonorBeforeReason	Br/HonraAntesDaRazao
HorribleJudgeOfCharacter	Br/PessimoJulgamentoDeCarater
HotterAndSexier	Br/MaisAtraenteESexy
HowWeGotHere	Br/ComoChegamosAqui
HumanPopsicle	Br/PicoleHumano
HumanoidAbomination	Br/AbominacaoHumanoide
HumansAreMorons	Br/HumanosSaoIdiotas
HumansAreTheRealMonsters	Br/HumanosSaoOsVerdadeirosMonstros
HumbleBeginnings	Br/ComecoHumilde
HumiliationConga	Br/CongaDaHumilhacao
HumiliationConga	Br/SequenciaHumilhante
Hypochondria	Br/{{Hipocondria}}
HypocriteHasAPoint	Br/OHipocritaTemRazao
IAteWhat	Br/EuComiOQue
ICantBelieveItsNotHeroin	Br/EuNaoAcreditoQueNaoEHeroina
IDidWhatIHadToDo	Br/EuFizOQueEuPrecisavaFazer
IDidWhatIHadToDo	Br/EuFizOQueEuTinhaQueFazer
IDieFree	Br/MorrereiLivre
IGaveMyWord	Br/EuDeiMinhaPalavra
IJustWantToBeSpecial	Br/EuSoQueriaSerEspecial
IKnowWhatWeCanDoCut	Br/CorteDeEuSeiOQuePodemosFazer
IKnowYouKnowIKnow	Br/EuSeiQueVoceSabeQueEuSei
INeverSaidItWasPoison	Br/EuNuncaDisseQueEraVeneno
IWantMyMommy	Br/EuQueroMinhaMamae
IWantSong	Br/CancaoDeEuQuero
IWorkAlone	Br/CavaleiroSolitario
IWorkAlone	Br/EuTrabalhoSozinho
IconicOutfit	Br/TrajeIconico
IdiotBall	Br/BolaDeIdiotabol
IdiotHoudini	Br/IdiotaHoudini
IdiotPlot	Br/TramaDeIdiotas
IgnoredEpiphany	Br/EpifaniaIgnorada
IgnoredExpert	Br/EspecialistaIgnorado
ImaginedInnuendo	Br/InsinuacaoImaginada
ImmediateSelfContradiction	Br/AutocontradicaoImediata
ImmortalLifeIsCheap	Br/VidaImortalEBarata
Immortality	Br/{{Imortalidade}}
ImmuneToBullets	Br/ImuneABalas
ImmuneToSlapstick	Br/ImuneAPastelao
ImplacableMan	Br/OImplacavel
ImpossiblyMundaneExplanation	Br/ExplicacaoImpossivelmenteMundana
ImprobableAimingSkills	Br/HabilidadeDeMiraImprovavel
InMediasRes	Br/InMediasRes
InTheBack	Br/PelasCostas
InTheirOwnImage	Br/AImagemESemelhanca
InUniverse	Br/InUniverso
IncitingIncident	Br/IncidenteIncitador
IndyPloy	Br/PlanoIndiana
InfallibleBabble	Br/BlaBlaBlaInfalivel
InfinityPlusOneSword	Br/EspadaDoInfinitoMaisUm
Infodump	Br/DespejoDeInformacao
InformedAttribute	Br/AtributoInformado
InnocentBystander	Br/ObservadorInocente
InnocentInnuendo	Br/InsinuacaoInocente
InspiredBy	Br/InspiradoPor
InstantlyProvenWrong	Br/InstantaneamenteProvadoErrado
InsufferableGenius	Br/GenioInsuportavel
InsufferableImbecile	Br/ImbecilInsuportavel
Intangibility	Br/{{Intangibilidade}}
IntendedAudienceReaction	Br/ReacaoEsperadaDoPublico
IntendedAudienceReaction	Br/ReacaoEsperadaDoPublico
IntercourseWithYou	Br/RelacoesComVoce
InternalHomage	Br/HomenagemInterna
InternalRetcon	Br/RetconInterno
InvincibleHero	Br/HeroiInvencivel
InvisibilityFlicker	Br/InvisibilidadeTremula
IronButtMonkey	Br/CorinhoDeFerro
IronicEcho	Br/EcoIronico
IronicEchoCut	Br/CorteDeEcoIronico
Irony	Br/{{Ironia}}
ItMayHelpYouOnYourQuest	Br/IssoPodeSerUtilEmSuaJornada
ItOnlyWorksOnce	Br/SoFuncionaUmaVez
ItWasHisSled	Br/EraOTrenoDele
ItWillNeverCatchOn	Br/IssoNuncaVaiPegar
ItsAllAboutMe	Br/TudoGiraAoMeuRedor
ItsAlwaysSpring	Br/SempreEPrimavera
ItsBeenDone	Br/JaFoiFeito
ItsNotSupposedToWinOscars	Br/NaoEParaGanharOOscar
ItsNotYouItsMyEnemies	Br/NaoEVoceSaoMeusInimigos
ItsQuietTooQuiet	Br/OMorroTaMuitoTranquilo
ItsTheSameNowItSucks	Br/NaoMudouNadaPorIssoEUmaDroga
JadeColoredGlasses	Br/OculosCorDeJade
JaywalkingWillRuinYourLife	Br/AtravessarForaDaFaixaVaiArruinarSuaVida
JerkWithAHeartOfGold	Br/BabacaComUmCoracaoDeOuro
JerkWithAHeartOfJerk	Br/BabacaComUmCoracaoDeBabaca
Jerkass	Br/{{Babaca}}
JerkassDissonance	Br/DissonanciaDeBabaca
JerkassHasAPoint	Br/OBabacaTemRazao
JerkassWoobie	Br/BabacaCoitadinho
JigsawPuzzlePlot	Br/EnredoQuebraCabeca
JigsawPuzzlePlot	Br/TramaQuebraCabeça
JokerImmunity	Br/ImunidadeDeCoringa
Jossed	Br/CaiuPorTerra
JumpPhysics	Br/FisicaDeSalto
JumpScare	Br/PuloDeSusto
JumpingOffTheSlipperySlope	Br/SeJogandoDaLadeiraEscorregadia
JumpingOutOfACake	Br/SaindoDeUmBolo
JumpingTheShark	Br/PularOTubarao
JustAsPlanned	Br/ExatamenteComoPlanejado	É uma redireção para "AllAccordingToPlan".
JustEatGilligan	Br/ApenasSeLivreDeGilligan
JustForFun	Br/ApenasPorLazer
JustForFun	Br/SoDeZoeira
JustForFun	Br/SoPelaDiversao
JustForFun	BrApenasPorLazer	Este deve ser usado se o "JustForFun" referenciado é um namespace.
JustForFun/IThoughtItMeant	BrApenasPorLazer/EuPenseiQueSignificava
JustForFun/NotToBeConfusedWith	BrApenasPorLazer/NaoConfundirCom
JustForFun/TVTropesAsAGatewayDrug	BrApenasPorLazer/TVTropesComoDrogaDeEntrada
JustForFun/TVTropesWillRuinYourLife	BrApenasPorLazer/TVTropesVaiArruinarASuaVida
JustForFun/TVTropesWillRuinYourVocabulary	BrApenasPorLazer/TVTropesVaiArruinarSeuVocabulario
JustForFun/TheTropelessTale	BrApenasPorLazer/OContoSemTropos
JustForFun/XMeetsY	BrApenasPorLazer/XEncontraY
JustForFun/YouKnowYouReadTooMuchTVTropesWhen	BrApenasPorLazer/VoceSabeQueEstaLendoMuitoTVTropesQuando
JustHereForGodzilla	Br/SoVimPeloGodzilla
JustOneMoreLevel	Br/SoMaisUmaFase
JustifiedTitle	Br/TituloJustificado
KarmaHoudini	Br/KarmaHoudini
KarmaHoudiniWarranty	Br/GarantiaDoKarmaHoudini
KarmaMeter	Br/MedidorDeCarma
KarmaMeter	Br/MedidorDeKarma
KarmicDeath	Br/MorteCarmica
KarmicDeath	Br/MorteKarmica
KeepingTheHandicap	Br/MantendoADeficiencia
Kevlard	Br/BanhaKevlar
KiManipulation	Br/ManipulacaoDeKi
KickTheDog	Br/ChutarOCachorro
KickTheMoralityPet	Br/ChutarAMoralDeEstimacao
KickedUpstairs	Br/ChutadoParaOAndarDeCima
KillItWithFire	Br/MateComFogo
KillTheGod	Br/MatarODeus
KillTheHostBody	Br/MateOHospedeiro
KilledOffForReal	Br/MortoPraValer
KinderAndCleaner	Br/MaisGentilELimpo
KindheartedSimpleton	Br/EstupidoDeBomCoracao
KnightErrant	Br/CavaleiroErrante
KnightTemplar	Br/CavaleiroTemplario
KnightTemplarBigBrother	Br/IrmaozaoCavaleiroTemplario
KnightTemplarParent	Br/PaiCavaleiroTemplario
KnowNothingKnowItAll	Br/SabeTudoQueNaoSabeNada
KudzuPlot	Br/TramaBalaioDeGato
KudzuPlot	Br/TramaEmaranhada
LackOfEmpathy	Br/FaltaDeEmpatia
LampshadeHanging	Br/IluminandoOTropo
LampshadeHanging	Br/LancandoLuz
LampshadeHanging	Br/LancarLuzSobreOTropo
LaserGuidedAmnesia	Br/AmnesiaComMiraLaser
LaserGuidedKarma	Br/CarmaGuiadoPorLaser
LaserGuidedKarma	Br/KarmaGuiadoPorLaser
LastNoteNightmare	Br/PesadeloDeUltimaNota
LaughTrack	Br/FaixaDeRiso
LawfulEvil	Br/LealEMau
LawfulGood	Br/LealEBom
LawfulNeutral	Br/LealENeutro
LawfulStupid	Br/LealEEstupido
LeaderFormsTheHead	Br/OLiderFormaACabeca
LetsYouAndHimFight	Br/VamosLutarVoceEEle
LightIsGood	Br/ALuzEBoa
LightIsNotGood	Br/ALuzNaoEBoa
LighterAndSofter	Br/MaisAnimadoELeve
LightingTropes	Br/TroposDeIluminacao
LikeAGodToMe	Br/ComoUmDeusParaMim
LikeRealityUnlessNoted	Br/TipoARealidadeANaoSerQueNaoSeja
LikeYouWouldReallyDoIt	Br/ComoSeVoceRealmenteFosseFazerIsso
ListOfTransgressions	Br/ListaDeTransgressoes
Literature/TheCanterburyTales	BrLiteratura/ContosDaCantuaria
Literature/TheKiteRunner	BrLiteratura/OCacadorDePipas
LoadsAndLoadsOfWriters	Br/MuitosEMuitosEscritores
LongList	Br/ListaLonga
LongRunners	Br/LongaDuracao
LongRunners	Br/SeriesDeLongaDuracao
LookBehindYou	Br/OlheAtrasDeVoce
LookWhatICanDoNow	Br/OlhaOQueEuSeiFazerAgora
LoopholeAbuse	Br/AbusoDasRegras
LordErrorProne	Br/LordePropensoAErros
LosingYourHead	Br/PerdendoACabeca
LostFoodGrievance	Br/DorPelaComidaPerdida
LostInImitation	Br/PerdidoNaImitacao
LoudGulp	Br/EngolindoSeco
LovableRogue	Br/RebeldeAdoravel
LoveInterests	Br/InteresseAmoroso
LoveItOrHateIt	Br/AmeOOuDeixeO
LoveToHate	Br/AmamOdiar
LowestCommonDenominator	Br/MinimoDivisorComum
LuddWasRight	Br/LuddEstavaCerto
LyingCreator	Br/CriadorMentiroso
LysistrataGambit	Br/GambitoDeLisistrata
MST3KMantra	Br/MantraMST3K
MacGuffinDeliveryService	Br/ServicoDeEntregaDeMacGuffin
MadArtist	Br/ArtistaMaluco
MadScientist	Br/CientistaMaluco
MadeOfIndestructium	Br/FeitoDeIndestructium
MadeOfIron	Br/FeitoDeFerro
MadeOfWin	Br/FeitoDeVitoria
MagazineDecay	Br/DecaimentoDaRevista
MagiBabble	Br/BlaBlaBlaMagico
MagicStaff	Br/CajadoMagico
MagicalComputer	Br/ComputadorMagico
MagnificentBastard	Br/CanalhaMagnifico
MalevolentArchitecture	Br/ArquiteturaMalevolente
MartialArtsStaff	Br/BastaoDeArtesMarciais
MasqueradeBall	Br/BaileDeMascaras
MasqueradeParadox	Br/ParadoxoDoMascaramento
MassOhCrap	Br/VishFerrouMassivo
MasterOfAll	Br/MestreDeTudo
MauveShirt	Br/CamisaLilas
MayItNeverHappenAgain	Br/QueIssoNuncaAcontecaDeNovo
MeaningfulFuneral	Br/FuneralSignificativo
MeasuringTheMarigolds	Br/MedirAsCalendulas
MediaWatchdog	Br/VigilanteDaMidia
MemeticMutation	Br/MutacaoMemetica
MentorArchetype	Br/ArquetipoMentor
MentorArchetype	Br/MentorArquetipico
MerchandiseDriven	Br/MovidoAPropaganda
MexicanStandoff	Br/ImpasseMexicano
MightMakesRight	Br/LeiDoMaisForte
MillionairePlayboy	Br/PlayboyMilionario
MindScrew	Br/ParafusoMental
MindScrewdriver	Br/ParafusadeiraMental
MinorFlawMajorBreakup	Br/PequenasFalhasGrandesRompimentos
MirrorCharacter	Br/OReflexo
MirrorMoralityMachine	Br/MaquinaDeEspelhoDaMoralidade
MisaimedRealism	Br/RealismoMalDirecionado
MissingStepsPlan	Br/PlanoIncompleto
MissionCreep	Br/ExpansaoDaMissao
MistakenForIndex	Br/ConfundidoComOIndice
MoneyDearBoy	Br/DinheiroMeuCaro
MonsterDelay	Br/MonstroTardio
MonsterMunch	Br/LancheDeMonstro
Mooks	Br/{{Capangas}}
MoralDisambiguation	Br/DesambiguacaoMoral
MoralGuardians	Br/GuardioesDaMoral
MoralMyopia	Br/MiopiaMoral
MoralSociopathy	Br/SociopatiaMoral
MoralityPet	Br/MoralDeEstimacao
MorePopularSpinoff	Br/DerivadoMaisPopular
MoreThanMindControl	Br/MaisQueControleMental
MortonsFork	Br/GarfoDeMorton
MostDefinitelyNotAVillain	Br/CertamenteNaoEUmVilao
MostTropersAreYoungNerds	Br/AMaioriaDosTropoeirosSaoNerdsJovens
MostTropersAreYoungNerds	Br/DemografiaTropoeira
MotivationalLie	Br/MentiraMotivacional
MotiveRant	Br/RetoricaJustificadora
Muggles	Br/{{Trouxas}}
MultipleGunshotDeath	Br/MortePorTirosMultiplos
MundaneObjectAmazement	Br/PerplexoComOObjetoMundano
MundaneUtility	Br/UtilidadeMundana
MurderBySuicide	Br/AssassinatoPorSuicidio
MurderTheHypotenuse	Br/AssassinarAHipotenusa
MusicalEpisode	Br/EpisodioMusical
MustMakeAmends	Br/DevoMeRedimir
MyDeathIsJustTheBeginning	Br/MinhaMorteESoOComeco
MyGodWhatHaveIDone	Br/MeuDeusOQueFoiQueEuFiz
MyWayOrTheHighway	Br/MeuJeitoOuNada
MysteriousNote	Br/BilheteMisterioso
MysteryCult	Br/CultoDeMisterio
MysticalPregnancy	Br/GravidezMistica
MythArc	Br/ArcoMitologico
MythologyGag	Br/PiadaMitologica
NamesToRunAwayFromReallyFast	Br/NomesParaSeAfastarOMaisRapidoPossivel
NarniaTime	Br/FusoNarnia
NarratingTheObvious	Br/NarrarOObvio
NarrativeFiligree	Br/FiligranaNarrativa
Narrator	Br/{{Narrador}}
NatureVersusNurture	Br/NaturezaOuCriacao
NecessarilyEvil	Br/NecessariamenteMau
NegativeContinuity	Br/ContinuidadeNegativa
Nepotism	Br/{{Nepotismo}}
NetworkDecay	Br/DecaimentoDaRede
NeutralEvil	Br/NeutroEMau
NeutralGood	Br/NeutroEBom
NeverFoundTheBody	Br/NuncaEncontraramOCorpo
NeverTheObviousSuspect	Br/NuncaEOSuspeitoMaisObvio
NeverTrustATrailer	Br/NuncaConfieNoTrailer
Newspeak	Br/{{Novilingua}}	1984, George Orwell.
NiceGuy	Br/CaraLegal
NiceJobBreakingItHero	Br/BomTrabalhoEstragandoTudoHeroi
NighInvulnerability	Br/PraticamenteInvulneravel
NightmareFuel	Br/CombustivelParaPesadelo
NightmareRetardant	Br/RetardanteDePesadelo
NinjaPirateZombieRobot	Br/NinjaPirataZumbiRobo
NoGoodDeedGoesUnpunished	Br/NenhumaBoaAcaoFicaImpune
NoMereWindmill	Br/NaoEUmMeroMoinho
NoOntologicalInertia	Br/SemInerciaOntologica
NoOriginStoriesAllowed	Br/NadaDeHistoriasDeOrigem
NoRomanticResolution	Br/SemResolucaoRomantica
NoSenseOfHumor	Br/SemSensoDeHumor
NobleBigot	Br/NobreIntolerante
NobleDemon	Br/DemonioNobre
NobodyPoops	Br/NinguemCaga
NonAppearingTitle	Br/NomeNaoExibido
NonIndicativeName	Br/NomeNaoIndicativo
NonProtagonistResolver	Br/SolucionadorNaoProtagonista
NotHisSled	Br/NaoEOTrenoDele
NotQuiteDead	Br/NaoExatamenteMorto
NotReallyABirthScene	Br/NaoERealmenteUmParto
NotSoAboveItAll	Br/NaoTaoAcimaDeTudo
NotSoDifferentRemark	Br/ComentarioDeNaoTaoDiferente
NotSoWellIntentionedExtremist	Br/ExtremistaNaoTaoBemIntencionado
NotWhatItLooksLike	Br/NaoEOQueParece
NothingIsScarier	Br/NadaEMaisAssustador
NothingIsTheSameAnymore	Br/NadaEMaisOMesmo
NumberOfTheBeast	Br/NumeroDaBesta
ObfuscatingInsanity	Br/InsanidadeOfuscante
ObfuscatingStupidity	Br/EstupidezOfuscante
ObscuredSpecialEffects	Br/EfeitosEspeciaisEncobertos
ObviousJudas	Br/JudasObvio
ObviousSecondChoice	Br/SegundaEscolhaObvia
ObviouslyEvil	Br/ObviamenteDoMal
ObviouslyEvil	Br/ObviamenteMaligno
OccamsRazor	Br/NavalhaDeOccam
OffWithHisHead	Br/CortemLheACabeca
OfficialCouple	Br/CasalOficial
OffscreenTeleportation	Br/TeleporteForaDaTela
OhAndXDies	Br/AhEXMorre
OhCrap	Br/VishFerrou
OlderThanFeudalism	Br/MaisVelhoQueOFeudalismo
OminousLatinChanting	Br/CoroOminosoEmLatim
OmnicidalManiac	Br/ManiacoOmnicida
OmniscientMoralityLicense	Br/LicencaDeMoralOnisciente
OncePerEpisode	Br/UmaVezPorEpisodio
OnlyFriend	Br/UnicoAmigo
OnlySaneByComparison	Br/SaoApenasEmComparacao
OnlySaneEmployee	Br/UnicoFuncionarioSao
OnlySaneMan	Br/UnicoHomemSao
OnlyTheLeadsGetAHappyEnding	Br/SoOsProtagonistasRecebemOFinalFeliz
OpeningACanOfClones	Br/AbrindoUmaLataDeClones
OpeningACanOfClones	Br/AbrirUmaLataDeClones
OpeningNarration	Br/NarracaoDeAbertura
OpportunisticBastard	Br/CanalhaOportunista
OrWasItADream	Br/SeraQueEraMesmoUmSonho
OrderVersusChaos	Br/OrdemContraCaos
OrwellianRetcon	Br/RetconOrwelliano
OscarBait	Br/IscaDeOscar
OtakuOClock	Br/OtakuEmPonto
OurGhostsAreDifferent	Br/NossosFantasmasSaoDiferentes
OurGodsAreDifferent	Br/NossosDeusesSaoDiferentes
OurLawyersAdvisedThisTrope	Br/NossosAdvogadosRecomendaramEsteTropo
OutdatedByCanon	Br/DesatualizadoPeloCanone
OverlyLongGag	Br/PiadaExcessivamenteLonga
OverlyLongName	Br/NomeExcessivamenteLongo
OvershadowedByControversy	Br/OfuscadoPelaControversia
PacifiedAdaptation	Br/AdaptacaoPacificada
PalsWithJesus	Br/AmigosDeJesus
ParanoiaFuel	Br/CombustivelPraParanoia
ParentalAbandonment	Br/AbandonoParental
ParentalBonus	Br/BonusAosPais
ParentalNeglect	Br/NegligenciaParental
Parody	Br/{{Parodia}}
PatchedTogetherFromTheHeadlines	Br/CosturadoComManchetes
PathOfInspiration	Br/CaminhoDaInspiracao
PatrickStewartSpeech	Br/DiscursoDoPatrickStewart
PayEvilUntoEvil	Br/PagarOMalComOMal
PaymentPlanPitch	Br/EsquemaDePagamento
PerfectHealth	Br/SaudePerfeita
PeripheryDemographic	Br/DemografiaPeriferica
Permadeath	Br/MortePermanente
PerpetualPoverty	Br/PobrezaPerpetua
PetTheDog	Br/AcariciarOCachorro
PetTheDog	Br/FazerCarinhoNoCachorro
PhallicWeapon	Br/ArmaFalica
PhlebotinumDuJour	Br/CoisoniumDuJour
PhysicalGod	Br/DeusFisico
PlausibleDeniability	Br/NegabilidadePlausivel
PlayTheGameSkipTheStory	Br/JogueOJogoPuleAHistoria
PlayedForLaughs	Br/IntencaoComica
PlayedForLaughs	Br/UsadoParaHumor
PlayedStraight	Br/UsoTipico
PlayfulHacker	Br/HackerBrincalhao
PlayingWithATrope	Br/BrincandoComTropos
PleaseSubscribeToOurChannel	Br/SeInscrevaEmNossoCanal
Plot	Br/{{Trama}}
PlotAllergy	Br/AlergiaDaTrama
PlotArmor	Br/ArmaduraDeTrama
PlotBasedPhotographObfuscation	Br/OfuscamentoDeFotografiaBaseadoEmTrama
PlotHole	Br/FuroNaTrama
PlotThreads	Br/LinhasDeTrama
PokeThePoodle	Br/CutucarOPoodle
PolishTheTurd	Br/PolirAMerda
PoorlyDisguisedPilot	Br/PilotoMalDisfarcado
PopCulturalOsmosis	Br/OsmoseDeCulturaPop
PopularityPower	Br/PoderDaPopularidade
PornWithoutPlot	Br/PornoSemHistoria
Post911TerrorismMovie	Br/FilmeDeTerrorismoPos119
PosthumousNarration	Br/NarracaoPostuma
PowerGlows	Br/PoderBrilha
PowerTrio	Br/TrioPoderoso
PowersThatBe	Br/PoderesQueSejam
PragmaticAdaptation	Br/AdaptacaoPragmatica
PragmaticEvil	Br/PragmaticoDoMal
PragmaticHero	Br/HeroiPragmatico
PrecociousCrush	Br/CrushPrecoce
Prequel	Br/{{Prequencia}}
PresentDayPast	Br/PassadoDoDiaPresente
PressXToDie	Br/PressioneXParaMorrer
Pride	Br/{{Orgulho}}
PrinciplesZealot	Br/ZeloteDosPrincipios
ProHumanTranshuman	Br/TranshumanoProHumanos
ProducedByCastMember	Br/ProduzidoPeloMembroDoElenco
ProductPlacement	Br/PosicionamentoDeProduto
PromotedFanboy	Br/FanboyPromovido
ProphecyTwist	Br/ReviravoltaNaProfecia
ProtagonistCenteredMorality	Br/MoralCentradaNoPersonagem
ProtagonistJourneyToVillain	Br/JornadaDoProtagonistaParaVilao
ProtectionFromEditors	Br/ProtecaoContraEditores
ProudWarriorRaceGuy	Br/CaraDeUmaRacaGuerreiraOrgulhosa
PsychicPowers	Br/PoderesPsiquicos
PsychoForHire	Br/PsicoticoDeAluguel
PsychoPsychologist	Br/PsicologoPsicotico
PsychologicalCombat	Br/CombatePsicologico
PsychoticSmirk	Br/SorrisoPsicotico
PublisherChosenTitle	Br/TituloEscolhidoPelaEmpresa
Pun	Br/{{Trocadalho}}
PunctuatedForEmphasis	Br/PontuadoParaEnfase
PunishedForSympathy	Br/PunidoPorSimpatia
PutOnABus	Br/ColocadoEmUmOnibus
PutOnABusToHell	Br/ColocadoEmUmOnibusParaOInferno
PutTheLaughterInSlaughter	Br/ColocarAGracaNaDesgraca
PuttingOnTheReich	Br/VestindoSeDeReich
PyrrhicVictory	Br/VitoriaPirrica
QuirkyWork	Br/ObraPeculiar
RageAgainstTheHeavens	Br/FuriaContraOsCeus
RageAgainstTheMentor	Br/FuriaContraOMentor
Railroading	Br/{{Empurramento}}
RandomEventsPlot	Br/TramaDeEventosAleatorios
RapeAsBackstory	Br/EstuproComoHistoriaDeFundo
RapeIsASpecialKindOfEvil	Br/EstuproEUmTipoEspecialDeMaldade
RayOfHopeEnding	Br/FinalRaioDeEsperanca
ReadTheFreakingManual	Br/LeiaADrogaDoManual
RealLife	Br/VidaReal
RealLifeWritesThePlot	Br/AVidaRealEscreveATrama
RealismInducedHorror	Br/TerrorInduzidoPorRealismo
RealityIsUnrealistic	Br/RealidadeEIrrealista
RealityWarper	Br/DobradorDeRealidade
RebelliousSpirit	Br/EspiritoRebelde
RecycledScript	Br/RoteiroReciclado
RedHerringShirt	Br/CamisaAvermelhada
RedOniBlueOni	Br/OniAzulOniVermelho
RedShirtArmy	Br/ExercitoDeCamisasVermelhas
RedemptionEarnsLife	Br/RedencaoConquistaAVida
RedemptionEqualsDeath	Br/RedencaoSignificaMorte
RedemptionFailure	Br/FalhaNaRedencao
RedemptionQuest	Br/JornadaDeRedencao
ReedRichardsIsUseless	Br/ReedRichardsEInutil
RefugeInAudacity	Br/RefugioNaAudacia
RememberTheNewGuy	Br/LembraDoCaraNovo
RememberWhenYouBlewUpASun	Br/LembraQuandoVoceExplodiuUmSol
RemoteBody	Br/CorpoRemoto
RemovableTurretGun	Br/TorretaRemovivel
ReplacementScrappy	Br/SubstitutoOdiado
RequiredSecondaryPowers	Br/PoderesSecundariosRequeridos
RescuedFromTheScrappyHeap	Br/ResgatadoDaPilhaDeLixo
ResetButton	Br/BotaoDeReinicio
RestrictedExpandedUniverse	Br/UniversoExpandidoRestrito
RestrictedRescueOperation	Br/OperacaoDeResgateRestrita
ResurrectionGambit	Br/GambitoDaRessurreicao
ResurrectiveImmortality	Br/ImortalidadeRessurreitiva
Retcon	Br/ContinuidadeRetroativa
Retconjuration	Br/{{Retconjuracao}}
Retgone	Br/RetconDeSumico
Retirony	Br/{{Aposentaironia}}
Retool	Br/{{Redefinicao}}
RevengeFic	Br/FanficDeVinganca
RevengeIsADishBestServed	Br/AVingancaEUmPratoQueSeCome
ReverseWhodunnit	Br/QuemFezIssoReverso
RevisedEnding	Br/FinalRevisado
Revision	Br/{{Revisao}}
RewatchBonus	Br/BonusPorReassistir
Rewrite	Br/{{Reescrita}}
Riddle	Br/{{Charada}}
RidingIntoTheSunset	Br/CavalgandoParaOPorDoSol
RippedFromTheHeadlines	Br/TiradoDasManchetes
RobotBuddy	Br/AmigoRobo
RoleEndingMisdemeanor	Br/DelitoDeEncerramentoDePapel
RomanceArc	Br/ArcoRomantico
RomanticPlotTumor	Br/TumorRomanticoDeTrama
RubberMan	Br/HomemBorracha
RuleOfCool	Br/PorqueELegal
RuleOfCool	Br/RegraDoLegal
RuleOfCute	Br/PorqueEFofo
RuleOfCute	Br/RegraDaFofura
RuleOfFunny	Br/PorqueEEngracado
RuleOfFunny	Br/RegraDaGraca
RuleOfThree	Br/RegraDoTres
RunOrDie	Br/CorrerOuMorrer
RunningOverThePlot	Br/AtropelarATrama
RussianReversal	Br/ReversalRussa
SNKBoss	Br/ChefeSNK
SacrificialLamb	Br/CordeiroDeSacrificio
SacrificialLion	Br/LeaoDeSacrificio
SadisticChoice	Br/EscolhaSadista
SafetyInMuggles	Br/SegurancaNosTrouxas
SaintlyChurch	Br/IgrejaSantificada
SanityBall	Br/BolaDaSanidade
SanitySlippage	Br/DeslizamentoDeSanidade
SarcasticConfession	Br/ConfissaoSarcastica
SarcasticDevotee	Br/DevotoSarcastico
Satan	Br/{{Sata}}
SatanicArchetype	Br/ArquetipoSatanico
SavedForTheSequel	Br/GuardadoParaASequencia
SavvyGuyEnergeticGirl	Br/CaraExperienteGarotaAgitada
SayYourPrayers	Br/ComeceARezar
SayingSoundEffectsOutLoud	Br/FalarEfeitosSonorosEmVozAlta
ScamReligion	Br/ReligiaoFraudulenta
ScamReligion	Br/ReligiaoGolpista
ScheherezadeGambit	Br/GambitoDeScheherezade
SciFiGhetto	Br/GuetoSciFi
SciFiWritersHaveNoSenseOfScale	Br/EscritoresDeSciFiNaoTemSensoDeEscala
ScienceAtTheSpeedOfPlot	Br/CienciaNaVelocidadeDaTrama
ScienceMarchesOn	Br/AMarchaDaCiencia
ScientificallyUnderstandableSorcery	Br/FeiticariaCientificamenteCompreensivel
ScrapbookStory	Br/HistoriaComRecortes
ScrappyMechanic	Br/MecanicaOdiada
ScratchDamage	Br/DanoDeArranhao
ScrewTheRulesIHaveMoney	Br/DaneSeAsRegrasEuTenhoDinheiro
ScrewedByTheNetwork	Br/DestruidoPelaRede
SeasonFluidity	Br/FluidezDeTemporada
SeasonalRot	Br/PodridaoSazonal
SecretMessageWink	Br/PiscadaDaMensagemSecreta
SeinfeldIsUnfunny	Br/SeinfeldNaoTemGraca
SelfDemonstratingArticle	Br/ArtigoAutoDemonstrativo
SelfDeprecating	Br/{{Autodepreciativo}}
SelfFulfillingProphecy	Br/ProfeciaAutorrealizavel
SenselessSacrifice	Br/SacrificioSemSentido
SequelDifficultyDrop	Br/QuedaDeDificuldadeDaSequencia
SequelDisplacement	Br/DeslocamentoDaSequencia
Sequelitis	Br/SequeliteCronica
Sequelitis	Br/{{Sequelite}}
SerialKiller	Br/AssassinoEmSerie
Series/HappyDays	BrSerie/DiasFelizes
Series/MorkAndMindy	BrSerie/MorkEMindy
Series/StarTrekTheOriginalSeries	BrSerie/StarTrekASerieOriginal
SeriesContinuityError	Br/ErroDeContinuidadeSerial
SeriesContinuityError	Br/ErroDeContinuidadeSerial
SeriousBusiness	Br/CoisaSeria
SeriousBusiness	Br/NegocioSerio
ServileSnarker	Br/SarcasticoServil
SesquipedalianLoquaciouness	Br/LoquacidadeSesquipedaliana
Settings	Br/{{Ambientacao}}
SevenDeadlySins	Br/SetePecadosCapitais
SexualEuphemism	Br/EufemismoSexual
ShaggyDogStory	Br/HistoriaPraBoiDormir
SharedUniverse	Br/UniversoCompartilhado
SheetOfGlass	Br/ChapaDeVidro
ShooOutTheNewGuy	Br/ExpulsarOCaraNovo
ShootTheDog	Br/AtirarNoCachorro
ShootTheShaggyDog	Br/AcordarOBoiATiros
ShortRunners	Br/CurtaDuracao
ShortRunners	Br/SeriesDeCurtaDuracao
ShoutOut	Br/MandandoUmSalve
ShowDontTell	Br/MostreNaoConte
ShownTheirWork	Br/MostraramSeuEmpenho
ShownTheirWork	Br/MostrouSeuEmpenho
ShrugOfGod	Br/ToNemAiDeDeus
ShutUpHannibal	Br/CalaABocaHannibal
ShutUpKirk	Br/CalaABocaKirk
SickAndWrong	Br/NojentoEErrado
SilentSnarker	Br/SarcasticoSilencioso
SiliconSnarker	Br/SarcasticoDeSilicio
SingerNamedrop	Br/FalarONomeDaBanda
SingleIssuePsychology	Br/PsicologiaDeProblemaUnico
SinisterGeometry	Br/GeometriaSinistra
SisterTrope	Br/TropoIrmao
SkewedPriorities	Br/PrioridadesDistorcidas
Slapstick	Br/{{Pastelao}}
SleeperHit	Br/SucessoInesperado
SliceOfLife	Br/VidaCotidiana
SlidingScaleOfComedyAndHorror	Br/EscalaMovelDeComediaETerror
SlidingScaleOfIdealismVersusCynicism	Br/EscalaMovelDeIdealismoVersusCinismo
SlidingScaleOfVillainThreat	Br/EscalaMovelDeAmeacaVilanica
SlippingAMickey	Br/BoaNoiteCinderela
SlowMotionDrop	Br/DerrubadaEmCameraLenta
SlowMotionFall	Br/QuedaEmCameraLenta
SmallReferencePools	Br/PequenoEspacoDeReferencia
SmallTownBoredom	Br/TedioDeCidadePequena
SmartPeoplePlayChess	Br/PessoasEspertasJogamXadrez
SmashCut	Br/CorteRapido
SnarkToSnarkCombat	Br/CombateEntreSarcasticos
SoBadItsGood	Br/TaoRuimQueEBom
SoLongAndThanksForAllTheGear	Br/AteMaisEObrigadoPelosEquipamentos
SoLongSuckers	Br/TchauzinhoOtarios
SoWhatDoWeDoNow	Br/EntaoOQueFaremosAgora
SociopathicHero	Br/HeroiSociopata
SoleSurvivor	Br/UnicoSobrevivente
SomeoneToRememberHimBy	Br/AlguemParaSeLembrarDele
SomethingElseAlsoRises	Br/AlgoMaisTambemSobe
SophomoreSlump	Br/CriseDoSegundoAno
SoreLoser	Br/MauPerdedor
SortingAlgorithmOfMortality	Br/AlgoritmoOrdenadorDeMortalidade
SoulSuckingRetailJob	Br/EmpregoPessimoDeAtendimentoAoPublico
SourSupporter	Br/ApoiadorAcido
SpaceWhaleAesop	Br/EsopoDeBaleiaEspacial
SpareAMessenger	Br/PouparUmMensageiro
SpareBodyParts	Br/PartesCorporaisExtras
SpeaksInShoutOuts	Br/FalarEmSalves
SpearCarrier	Br/PortadorDeLanca
SpecialEffectFailure	Br/DefeitosEspeciais
SpecialEffectsFailure	Br/DefeitosEspeciais
SpecialGuest	Br/ConvidadoEspecial
SpentShellsShower	Br/ChuvaDeCartuchosGastos
SpiritualSuccessor	Br/SucessorEspiritual
SpoiledBrat	Br/PirralhoMimado
SpoilerOpening	Br/IntroducaoComSpoiler
SpoileredRotten	Br/FedendoASpoilers
SportsStoryTropes	Br/TroposDeHistoriasDeEsportes
SpotlightStealingSquad	Br/EsquadraoDeRouboDoHolofote
SpringtimeForHitler	Br/PrimaveraParaHitler
StableTimeLoop	Br/CicloTemporalEstavel
StandardHeroReward	Br/RecompensaPadraoDoHeroi
StandardizedLeader	Br/LiderPadronizado
StarfishAlien	Br/AliensEsquisitos
StartOfDarkness	Br/ComecoDasTrevas
StaticCharacter	Br/PersonagemEstatico
StatusQuoGameShow	Br/ProgramaDePalcoDoStatusQuo
StatusQuoIsGod	Br/StatusQuoEDeus
StayingAlive	Br/PermanecendoVivo
StillbornFranchise	Br/FranquiaNatimorta
StopWorshippingMe	Br/PareDeMeIdolatrar
StraightGay	Br/GayHetero
StraightMan	Br/HomemSerio
StraightMan	Br/HomemSerio
StraightManAndWiseGuy	Br/HomemSerioECaraSagaz
StreetSmart	Br/ConhecedorDasRuas
StreetUrchin	Br/OArruaceiro
StrictlyFormula	Br/FormulaEstrita
StrongAsTheyNeedToBe	Br/TaoForteQuantoNecessario
StupidEvil	Br/EstupidoEMau
StupidGood	Br/EstupidoEBom
StupidNeutral	Br/EstupidoENeutro
SubTrope	Br/SubTropo
Subtext	Br/{{Subtexto}}
SubvertedTrope	Br/TropoSubvertido
SuddenSchoolUniform	Br/UniformeEscolarSubito
SugarWiki	BrWikiAlegre	"Sugar Wiki" é um namespace.
SugarWiki/AwesomeMusic	BrSugarWiki/MusicaFantastica
SugarWiki/MomentOfAwesome	BrWikiAlegre/MomentoFantastico
SugarWiki/TVTropesWillEnhanceYourLife	BrWikiAlegre/TVTropesVaiMelhorarSuaVida
SuperHero	Br/SuperHeroi
SuperSmoke	Br/SuperFumaca
SuperToughness	Br/SuperResistencia
SuperTrope	Br/SuperTropo
SurpriseDifficulty	Br/DificuldadeSurpresa
SurprisinglyGentleSong	Br/MusicaSurpreendentementeCalma
SurprisinglyImprovedSequel	Br/SequenciaSurpreendentementeMelhor
SurprisinglyRealisticOutcome	Br/ResultadoSurpreendentementeRealista
SurroundedByIdiots	Br/CercadoPorIdiotas
SurroundedBySmartPeople	Br/CercadoPorGenteEsperta
SuspiciouslySimilarSubstitute	Br/SubstitutoEstranhamenteSimilar
TVNeverLies	Br/ATelevisaoNuncaMente
TVTelephoneEtiquette	Br/BonsModosAoTelefoneNaTelevisao
TabletopGame/DungeonsAndDragons	BrJogoDeMesa/DungeonsAndDragons
TabletopGame/{{Chess}}	BrJogoDeMesa/{{Xadrez}}
TabletopGames	Br/JogosDeMesa
TacticalReminiscence	Br/RecordacaoTatica
Tagline	Br/FraseDeEfeito
TakeAThirdOption	Br/EscolherUmaTerceiraOpcao
TakeOverTheWorld	Br/DominarOMundo
TakeThat	Br/TomaEssa
TakeThatScrappy	Br/TomaEssaOdiado
TakesOneToKillOne	Br/ENecessarioUmParaMatarUm
TakingTheBullet	Br/LevandoOTiro
TalkToEveryone	Br/FaleComTodoMundo
TallDarkAndSnarky	Br/AltoTrevosoESarcastico
TamerAndChaster	Br/MaisMansoECasto
TaughtByExperience	Br/AprendeuPelaExperiencia
TautologicalTemplar	Br/TemplarioTautologico
TearDryer	Br/SecadorDeLagrimas
TearJerker	Br/ArrancadorDeLagrimas
TechBro	Br/CaraDaTecnologia
TechnicalAdvisor	Br/ConsultorTecnico
TechnoBabble	Br/BlaBlaBlaTecnologico
TechnologyMarchesOn	Br/AMarchaDaTecnologia
TemporarilyExaggeratedTrait	Br/AspectoTemporariamenteExagerado
TemptingFate	Br/DesafiarODestino
TemptingFate	Br/ProvocarODestino
TerribleTrio	Br/TrioTerrivel
ThanatosGambit	Br/GambitoDeThanatos
ThatCameOutWrong	Br/IssoSaiuErrado
ThatOneLevel	Br/AquelaFase
ThatsWhatSheSaid	Br/FoiOQueElaDisse
TheArtifact	Br/OArtefato
TheAtoner	Br/OExpiador
TheBadGuyWins	Br/OCaraMauVence
TheBerserker	Br/OEnfurecido
TheBigGuy	Br/OGrandao
TheBully	Br/OValentao
TheButlerDidIt	Br/FoiOMordomoQuemFez
TheCape	Br/ACapa
TheCasanova	Br/OCasanova
TheCastShowoff	Br/OExibidoDoElenco
TheCharacterDiedWithHim	Br/OPersonagemMorreuComEle
TheCharmer	Br/OEncantador
TheChessmaster	Br/OMestreEnxadrista
TheChrisCarterEffect	Br/EfeitoChrisCarter
TheComplainerIsAlwaysWrong	Br/QuemReclamaEstaSempreErrado
TheComputerIsACheatingBastard	Br/OComputadorEUmCanalhaTrapaceiro
TheComputerIsYourFriend	Br/OComputadorESeuAmigo
TheCorrupter	Br/OCorruptor
TheCuckoolanderWasRight	Br/OLunaticoEstavaCerto
TheDeterminator	Br/ODeterminado
TheDissenterIsAlwaysRight	Br/ODissidenteEstaSempreCerto
TheDividual	Br/ODividuo
TheDragon	Br/ODragao
TheEighties	Br/Anos80
TheEmperor	Br/OImperador
TheEmpire	Br/OImperio
TheEndOfTheWorldAsWeKnowIt	Br/OFimDoMundoComoNosConhecemos
TheEndOrIsIt	Br/OFimOuSeraQueNao
TheEveryman	Br/OMediano
TheEvilGenius	Br/GenioDoMal
TheEvilsOfFreeWill	Br/OsMalesDoLivreArbitrio
TheExtremistWasRight	Br/OExtremistaEstavaCerto
TheFettered	Br/OAcorrentado
TheFilmOfTheBook	Br/OFilmeDoLivro
TheFireflyEffect	Br/EfeitoFirefly
TheFourthWallWillNotProtectYou	Br/AQuartaParedeNaoTeProtegera
TheFundamentalist	Br/OFundamentalista
TheGambler	Br/OApostador
TheGoodGuysAlwaysWin	Br/OsBonzinhosSempreVencem
TheGraphShowsTheTrend	Br/OGraficoMostraATendencia
TheGreatestStoryNeverTold	Br/AMaiorHistoriaJamaisContada
TheGunslinger	Br/OPistoleiro
TheHeart	Br/OCoracao
TheHeretic	Br/OHerege
TheHero	Br/OHeroi
TheHeroDies	Br/OHeroiMorre
TheHerosJourney	Br/AJornadaDoHeroi
TheHerosJourney	Br/JornadaDoHeroi
TheHomewardJourney	Br/AViagemDeVolta
TheHorseshoeEffect	Br/EfeitoFerradura
TheJuggernaut	Br/OIrrefreavel
TheLancer	Br/OLanceiro
TheMainCharactersDoEverything	Br/OsPersonagensPrincipaisFazemTudo
TheManBehindTheMan	Br/OHomemPorTrasDoHomem
TheMcCoy	Br/OMcCoy
TheMenInBlack	Br/OsHomensDePreto
TheMountainsOfIllinois	Br/AsMontanhasDoAmazonas	Adaptado considerando a geografia de ambos locais.
TheMovie	Br/OFilme
TheNamesake	Br/OHomonimo
TheNewAdventures	Br/AsNovasAventuras
TheNineties	Br/Anos90
TheOnlyOne	Br/OUnico
TheOrder	Br/AOrdem
TheOtherDarrin	Br/OOutroJames	Na dublagem de "Bewitched", o Darrin se chama James.
ThePlan	Br/OPlano
ThePlotReaper	Br/OCeifadorDeTramas
ThePowerOfIndex	Br/OPoderDoIndice
ThePowerOfLove	Br/OPoderDoAmor
ThePowerOfRock	Br/OPoderDoRock
ThePrankster	Br/OTravesso
TheProducerThinksOfEverything	Br/OProdutorPensaEmTudo
ThePurge	Br/OExpurgo
TheReasonYouSuckSpeech	Br/DiscursoSobrePorQueVoceEHorrivel
TheReliableOne	Br/OConfiavel
TheRemnant	Br/ORemanescente
TheReveal	Br/ARevelacao
TheScrappy	Br/OOdiado
TheSingularity	Br/ASingularidade
TheSixties	Br/Anos60
TheSmartGuy	Br/CaraEsperto
TheSnarkKnight	Br/CavaleiroSarcastico
TheSocialDarwinist	Br/DarwinistaSocial
TheSocialExpert	Br/OEspecialistaSocial
TheSociopath	Br/OSociopata
TheSpock	Br/OSpock
TheStoic	Br/OEstoico
TheSummation	Br/OResumoDaOpera
TheTapeKnewYouWouldSayThat	Br/AFitaSabiaQueVoceDiriaIsso
TheTeamNormal	Br/OCaraComumDoGrupo
TheThemeParkVersion	Br/VersaoParqueTematico
TheTrickster	Br/OMalandro
TheTrickster	Br/OTrapaceiro
TheTriple	Br/OTriplo
TheUnfettered	Br/OIrrestrito
TheUnfought	Br/ONaoEnfrentado
TheUnmasquedWorld	Br/OMundoDesmascarado
TheUnreveal	Br/ANaoRevelacao
TheVamp	Br/AVamp
TheVamp	Br/AVampe
TheVerse	Br/OVerso
TheVirus	Br/OVirus
TheWalrusWasPaul	Br/AMorsaEraPaul
TheWonka	Br/OWonka
TheWoobie	Br/OCoitadinho
TheWorfEffect	Br/EfeitoWorf
TheWorldIsNotReady	Br/OMundoNaoEstaPronto
TheWorldsExpertOnGettingKilled	Br/OEspecialistaMundialEmSerMorto
TheoryOfNarrativeCausality	Br/TeoriaDaCausalidadeNarrativa
TheresNoPlaceLikeHome	Br/NaoHaLugarMelhorQueOLar
TheyChangedItNowItSucks	Br/ElesMudaramPorIssoEUmaDroga
TheyKilledKennyAgain	Br/ElesMataramOKennyDeNovo
TheyLookLikeUsNow	Br/AgoraElesSeParecemConosco
ThingsAreMoreEffectiveInHollywood	Br/CoisasSaoMaisEficazesEmHollywood
ThinksOfSomethingSmartSaysSomethingStupid	Br/PensaEmAlgoInteligenteDizAlgoEstupido
ThirteenIsUnlucky	Br/TrezeSignificaAzar
ThisCannotBe	Br/NaoPodeSer
ThisImageIsNotAnExample	Br/EstaImagemNaoEUmExemplo
ThisIndexIsAnachronistic	Br/EsteIndiceEAnacronico
ThisIsGonnaSuck	Br/IssoVaiDoer
ThisLoserIsYou	Br/EsteFracassadoEVoce
ThisLoserIsYou	Br/EstePerdedorEVoce
ThouShaltNotKill	Br/NaoMataras
Thoughtcrime	Br/CrimeDePensamento
ThreePlusTwo	Br/TresMaisDois
ThroughTheEyesOfMadness	Br/AtravesDosOlhosDaLoucura
ThrowItIn	Br/DeixarAiMesmo
TimeMarchesOn	Br/AMarchaDoTempo
TimeTravel	Br/ViagemNoTempo
TimeyWimeyBall	Br/BolaDeTempobol
TitleDrop	Br/FalarONome
TitleDropAnthology	Br/AntologiaQueTrazONome
TitleDropChapter	Br/CapituloQueTrazONome
TitleScream	Br/GritarOTitulo
TitleThemeTune	Br/MusicaTemaDoTitulo
ToAbsentFriends	Br/AosAmigosAusentes
ToBeLawfulOrGood	Br/SerLealOuSerBom
TokenEvilTeammate	Br/ParceiroCotistaDoMal
ToneShift	Br/MudancaDeTom
TonightSomeoneDies	Br/EstaNoiteAlguemVaiMorrer
TooBleakStoppedCaring	Br/SombrioDemaisParaMeImportar
TooCoolToLive	Br/LegalDemaisParaViver
TooDumbToFool	Br/BurroDemaisParaEnganar
TooDumbToLive	Br/BurroDemaisParaViver
TooGoodForExploiters	Br/BomDemaisParaAproveitadores
TooGoodForThisSinfulEarth	Br/BomDemaisParaEstaTerraPecadora
TooHappyToLive	Br/FelizDemaisParaMorrer
TooIncompetentToOperateABlanket	Br/BurroDemaisParaUsarUmCobertor
TooManyCooksSpoilTheSoup	Br/CozinheirosDemaisEstragamASopa
TooPowerfulToLive	Br/PoderosoDemaisParaViver
TookALevelInDumbass	Br/SubiuDeNivelEmBurrice
TookALevelInJerkass	Br/SubiuDeNivelEmBabaquice
TookALevelInKindness	Br/SubiuDeNivelEmBondade
TorchTheFranchiseAndRun	Br/IncendiarAFranquiaECorrer
TotalitarianUtilitarian	Br/TotalitarioUtilitario
TotallyRadical	Br/TotalmenteRadical
TradeSnark	Br/GracaRegistrada
TrademarkFavoriteFood	Br/ComidaPrediletaRegistrada
TragicBigot	Br/IntoleranteTragico
TravelingAtTheSpeedOfPlot	Br/ViajandoNaVelocidadeDaTrama
TrialAndErrorGameplay	Br/JogoDeTentativaEErro
TricksterMentor	Br/MentorTrapaceiro
TrojanPrisoner	Br/PrisioneiroDeTroia
TrollingCreator	Br/CriadorSacana
Trope	Br/{{Tropo}}
TropeCodifier	Br/CodificadorDeTropo
TropeMaker	Br/CriadorDeTropo
TropeNamers	Br/NomeadorDeTropo
TropeTelegraphing	Br/TelegrafandoOTropo
TropeTrigger	Br/GatilhoDeTropo
Troperrific	Br/{{Tropotastico}}
Tropes	Br/{{Tropos}}	Não é a mesma página que "tropo".
TropesAreTools	Br/TroposSaoFerramentas
TropesHiddenFromAudience	Br/TroposEscondidosDaPlateia
TroubledSympatheticBigot	Br/IntolerantePerturbadoESimpatico
TrueArt	Br/VerdadeiraArte
TrueArtIsIncomprehensible	Br/AVerdadeiraArteEIncompreensivel
TrueLoveIsBoring	Br/AmorVerdadeiroEEntediante
TrueNeutral	Br/NeutroNeutro
TrueNeutral	Br/VerdadeiroNeutro
TwistEnding	Br/FinalDeReviravolta
TwoDecadesBehind	Br/DuasDecadasAtrasado
TwoGuysAndAGirl	Br/DoisCarasEUmaGarota
UnCanceled	Br/{{Descancelado}}
UnConfession	Br/NaoConfissao
UnbuiltTrope	Br/TropoNaoConstruido
UncannyValley	Br/ValeSinistro
Uncoffee	Br/{{Descafe}}
UnconventionalAlignment	Br/AlinhamentoNaoConvencional
UnfazedEveryman	Br/SujeitoInabalavel
UnintentionalPeriodPiece	Br/ObraDeEpocaNaoIntencional
UnintentionalPeriodPiece	Br/TrabalhoNaoIntencionalmenteDeEpoca
UnintentionallySympathetic	Br/SimpatiaNaoIntencional
UnlikelySpare	Br/ItemReservaImprovavel
UnprocessedResignation	Br/DemissaoNaoProcessada
UnreliableNarrator	Br/NarradorNaoConfiavel
UnresolvedSexualTension	Br/TensaoSexualNaoResolvida
UnscientificScience	Br/CienciaIncientifica
UnstableEquilibrium	Br/EquilibrioInstavel
UnstoppableRage	Br/FuriaIncontrolavel
UnsuccessfulPetAdoption	Br/AdocaoMalSucedidaDeAnimal
UnusualEuphemism	Br/EufemismoIncomum
UnusuallyUninterestingSight	Br/VistaIncomumDesinteressante
UnwantedFalseFaith	Br/FalsaFeIndesejada
UnwittingInstigatorOfDoom	Br/InstigadorInvoluntarioDoCaos
UnwittingPawn	Br/PeaoInvoluntario
UpbringingMakesTheHero	Br/AEducacaoFazOHeroi
UrExample	Br/UrExemplo
UriahGambit	Br/GambitoDeUrias
UsedToBeASweetKid	Br/CostumavaSerUmBomGaroto
UsefulNotes	BrNotasUteis
UsefulNotes/ArcadeGame	BrNotasUteis/JogosDeArcade
UsefulNotes/LogicalFallacies	BrNotasUteis/FalaciasLogicas
UsefulNotes/NintendoEntertainmentSystem	BrNotasUteis/NintendoEntertainmentSystem
UsefulNotes/TVStrikes	BrNotasUteis/GrevesNoMeioTelevisivo
UsefulNotes/TheCrusades	BrNotasUteis/AsCruzadas
UsefulNotes/TheGreatVideoGameCrashOf1983	BrNotasUteis/CriseDosVideogamesDe1983
UsefulNotes/TheKnightsHospitallers	BrNotasUteis/OrdemDeMalta
UsefulNotes/TheKnightsTemplar	BrNotasUteis/OrdemDosTemplarios
UsefulNotes/TheRuralPurge	BrNotasUteis/ExpurgoRural
UsefulNotes/TheTeutonicKnights	BrNotasUteis/OrdemTeutonica
UsefulNotes/TheWarOnTerror	BrNotasUteis/AGuerraAoTerror
UtopiaJustifiesTheMeans	Br/UtopiaJustificaOsMeios
ValuesDissonance	Br/DissonanciaDeValores
VegetarianForADay	Br/VegetarianoPorUmDia
VeryLooselyBasedOnATrueStory	Br/VagamenteBaseadoEmUmaHistoriaReal
VictoryIsBoring	Br/VencerEChato
VideoGameCrueltyPunishment	Br/PunicaoDosVideogamesPelaCrueldade
VideoGameLives	Br/VidasDeVideogame
ViewersAreGeniuses	Br/EspectadoresSaoGenios
ViewersAreGoldfish	Br/EspectadoresSaoPeixinhosDourados
ViewersAreMorons	Br/EspectadoresSaoIdiotas
VillainDecay	Br/DecaimentoVilanico
VillainExitStageLeft	Br/SaidaDoVilaoPelaEsquerda
VillainProtagonist	Br/VilaoProtagonista
VillainWithGoodPublicity	Br/VilaoComBoaPublicidade
VillainousBSOD	Br/ColapsoVilanico
VillainousLineage	Br/LinhagemVilanesca
VillainousPlanInertia	Br/InerciaDoPlanoDoMal
VillainsActHeroesReact	Br/ViloesAgemHeroisReagem
VindicatedByHistory	Br/VingadoPelaHistoria
VisionaryVillain	Br/VilaoVisionario
VisualInnuendo	Br/InsinuacaoVisual
VisualPun	Br/TrocadalhoVisual
VisualTitleDrop	Br/MostrarONome
VocalMinority	Br/MinoriaVocal
VulgarHumor	Br/HumorVulgar
WagTheDirector	Br/SacudirODiretor
WainscotSociety	Br/SociedadeLambril
WakeUpCallBoss	Br/ChefeDeAlerta
Wangst	Br/{{Choradeira}}
WarriorMonk	Br/MongeGuerreiro
WartimeWedding	Br/CasamentoEmTemposDeGuerra
WasTooHardOnHim	Br/FoiMuitoDuroComEle
WasTooHardOnHim	Br/FuiMuitoDuroComEle
Watershed	Br/MudancaDeAguas
WeWantOurIdiotBack	Br/QueremosNossoIdiotaDeVolta
WeWantOurJerkBack	Br/QueremosNossoBabacaDeVolta
WeakButSkilled	Br/FracoMasHabilidoso
WeakButSkilled	Br/FracoPoremHabilidoso
Webcomic	BrQuadrinhosWeb
WeirdnessCensor	Br/CensorDeEsquisitice
WellDoneSonGuy	Br/CaraDoBomTrabalhoFilho
WellDoneSonGuy	Br/CaraDoMuitoBemFilho
WellIntentionedExtremist	Br/ExtremistaBemIntencionado
WellThisIsNotThatTrope	Br/BomEsteNaoEEsseTropo
WesternAnimation	BrAnimacaoOcidental
WesternAnimation/FamilyGuy	BrAnimacaoOcidental/UmaFamiliaDaPesada
WesternAnimation/KuboAndTheTwoStrings	BrAnimacaoOcidental/KuboEAsCordasMagicas
WesternAnimation/RickAndMorty	BrAnimacaoOcidental/RickEMorty
WesternAnimation/TheSimpsons	BrAnimacaoOcidental/OsSimpsons
WhamEpisode	Br/AqueleEpisodio
WhamLine	Br/AquelaFrase
WhatASenselessWasteOfHumanLife	Br/QueDesperdicioInutilDeVidaHumana
WhatCouldHaveBeen	Br/OQuePoderiaTerSido
WhatDoYouMeanItsNotForKids	Br/ComoAssimNaoEParaCriancas
WhatHappenedToTheMouse	Br/MasOQueHouveComORato
WhatIsEvil	Br/OQueEOMal
WhatTheHellHero	Br/QueMerdaEEssaHeroi
WhatTheHellPlayer	Br/QueMerdaEEssaJogador
WhenAllYouHaveIsAHammer	Br/QuandoTudoQueSeTemEUmMartelo
WhoNamesTheirKidDude	Br/QuemChamaOFilhoDeMano
Whodunnit	Br/QuemFezIsso
WhosLaughingNow	Br/QuemEstaRindoAgora
WhyDidItHaveToBeSnakes	Br/PorQueTinhaQueSerCobras
WikiWalk	Br/WikiPasseio
WildCard	Br/OCoringa
WillTheyOrWontThey	Br/SeraQueElesVaoOuNao
WillingSuspensionOfDisbelief	Br/SuspensaoVoluntariaDaDescrenca
WinBackTheCrowd	Br/ReconquistarOPublico
WindsOfDestinyChange	Br/VentosDoDestinoMudem
WiseBeyondTheirYears	Br/MaisSabioDoQueAparenta
WithUsOrAgainstUs	Br/ConoscoOuContraNos
WithinArmsReach	Br/AoAlcanceDaMao
WolverinePublicity	Br/PropagandaWolverine
WonderChild	Br/CriancaMaravilhosa
WoobieDestroyerOfWorlds	Br/CoitadinhoODestruidorDeMundos
WordOfGod	Br/PalavraDeDeus
WorkingTitle	Br/TituloTemporario
WorldGoneMad	Br/MundoMaluco
WorldHealingWave	Br/OndaDeCuraGlobal
WorldOfSnark	Br/{{Sarcasmolandia}}
WorstNewsJudgementEver	Br/PessimaPrioridadeDeNoticias
WorstNewsJudgmentEver	Br/PessimaPrioridadeDeNoticias
WriteWhatYouKnow	Br/EscrevaOQueVoceConhece
WriterOnBoard	Br/EscritorABordo
WritersCannotDoMath	Br/EscritoresNaoSabemMatematica
WritersCannotDoMath	Br/RoteiristasNaoSabemMatematica
WrittenByTheWinners	Br/EscritoPelosVencedores
WrongGenreSavvy	Br/LigadoNoGeneroErrado
WrongTurnAtAlbuquerque	Br/CurvaErradaEmAlbuquerque
XanatosGambit	Br/GambitoDeXanatos
XanatosSpeedChess	Br/XadrezRapidoDeXanatos
YankTheDogsChain	Br/PuxarACorrenteDoCachorro
YoYoPlotPoint	Br/IoioDeTrama
YouAreFat	Br/VoceEGordo
YouAreWhatYouHate	Br/VoceEOQueVoceOdeia
YouBastard	Br/SeuCanalha
YouCantKillWhatsAlreadyDead	Br/VoceNaoPodeMatarOQueJaEstaMorto
YouCantThwartStageOne	Br/VoceNaoPodeImpedirOEstagioUm
YouHaveGotToBeKiddingMe	Br/VoceSoPodeEstarDeBrincadeira
YouJustToldMe	Br/VoceAcabouDeMeDizer
YouWatchTooMuchX	Br/VoceEstaVendoMuitoX
YouWouldntLikeMeWhenImAngry	Br/VoceNaoVaiQuererMeVerFurioso
YoungerAndHipper	Br/MaisJovemEManeiro
YourApprovalFillsMeWithShame	Br/SuaAprovacaoMeEncheDeVergonha
YourMagicsNoGoodHere	Br/SuaMagiaNaoFuncionaNestasBandas
YoureInsane	Br/VoceELouco
ZerothLawRebellion	Br/RebeliaoDaLeiZero
